Estado;Município;Total Residente;Residente Brasileira;Brasileira Nata;Brasileira por naturalização;Residente Estrangeira;Código da Unidade Geográfica
Rondônia;Ariquemes;90353;90240;90140;101;113;1100023.0
Rondônia;Área 001;16632;16567;16552;14;65;1100023003001.0
Rondônia;Área 002;17183;17167;17151;17;16;1100023003002.0
Rondônia;Área 003;28009;27996;27987;9;13;1100023003003.0
Rondônia;Área 004;28529;28510;28449;61;19;1100023003004.0
Rondônia;Buritis;32383;32341;32299;41;42;1100452.0
Rondônia;Área 001;18149;18138;18112;26;11;1100452003001.0
Rondônia;Área 002;14234;14202;14187;15;32;1100452003002.0
Rondônia;Cacoal;78574;78536;78461;75;38;1100049.0
Rondônia;Área 001;14571;14571;14558;13;0;1100049003001.0
Rondônia;Área 002;20356;20336;20311;25;20;1100049003002.0
Rondônia;Área 003;20650;20631;20595;36;19;1100049003003.0
Rondônia;Área 004;22997;22997;22997;0;0;1100049003004.0
Rondônia;Guajará-Mirim;41656;40709;40318;391;947;1100106.0
Rondônia;Área 001;15864;15519;15288;231;345;1100106003001.0
Rondônia;Área 002;25792;25190;25030;160;602;1100106003002.0
Rondônia;Jaru;52005;51978;51894;84;27;1100114.0
Rondônia;Área 001;20600;20587;20554;33;13;1100114003001.0
Rondônia;Área 002;31405;31391;31341;50;14;1100114003002.0
Rondônia;Ji-Paraná;116610;116507;116373;134;103;1100122.0
Rondônia;Área 001;12900;12882;12846;36;18;1100122003001.0
Rondônia;Área 002;15049;15040;15028;12;9;1100122003002.0
Rondônia;Área 003;15781;15769;15769;0;12;1100122003003.0
Rondônia;Área 004;16325;16324;16316;8;1;1100122003004.0
Rondônia;Área 005;25097;25090;25090;0;7;1100122003005.0
Rondônia;Área 006;31458;31402;31324;78;56;1100122003006.0
Rondônia;Machadinho D'Oeste;31135;31135;31125;10;0;1100130.0
Rondônia;Área 001;16339;16339;16339;0;0;1100130003001.0
Rondônia;Área 002;14796;14796;14786;10;0;1100130003002.0
Rondônia;Ouro Preto do Oeste;37928;37928;37805;123;0;1100155.0
Rondônia;Área 001;14341;14341;14258;83;0;1100155003001.0
Rondônia;Área 002;23587;23587;23547;40;0;1100155003002.0
Rondônia;Pimenta Bueno;33822;33806;33796;10;16;1100189.0
Rondônia;Área 001;14986;14970;14970;0;16;1100189003001.0
Rondônia;Área 002;18836;18836;18826;10;0;1100189003002.0
Rondônia;Porto Velho;428527;427841;427356;485;686;1100205.0
Rondônia;Área 001;16134;16104;16076;28;30;1100205004001.0
Rondônia;Área 002;16030;15967;15955;12;63;1100205004002.0
Rondônia;Área 003;19242;19230;19200;30;12;1100205004003.0
Rondônia;Área 004;17788;17778;17778;0;10;1100205004004.0
Rondônia;Área 005;18384;18331;18324;7;53;1100205004005.0
Rondônia;Área 006;16951;16930;16914;17;21;1100205004006.0
Rondônia;Área 007;16490;16485;16474;10;5;1100205004007.0
Rondônia;Área 008;18202;18188;18188;0;14;1100205004008.0
Rondônia;Área 009;15174;15174;15174;0;0;1100205004009.0
Rondônia;Área 010;16009;15993;15975;18;16;1100205004010.0
Rondônia;Área 011;18434;18408;18408;0;26;1100205004011.0
Rondônia;Área 012;22773;22773;22724;49;0;1100205004012.0
Rondônia;Área 013;16576;16537;16526;11;39;1100205004013.0
Rondônia;Área 014;23238;23202;23161;42;36;1100205004014.0
Rondônia;Área 015;18568;18549;18523;27;19;1100205004015.0
Rondônia;Área 016;14150;14122;14088;34;28;1100205004016.0
Rondônia;Área 017;14246;14213;14113;100;33;1100205004017.0
Rondônia;Área 018;28029;27919;27881;38;110;1100205004018.0
Rondônia;Área 019;15221;15133;15092;41;88;1100205004019.0
Rondônia;Área 020;20650;20623;20623;0;27;1100205004020.0
Rondônia;Área 021;31278;31278;31278;0;0;1100205004021.0
Rondônia;Área 022;34960;34904;34883;21;56;1100205004022.0
Rondônia;Rolim de Moura;50648;50614;50537;77;34;1100288.0
Rondônia;Área 001;21328;21294;21264;30;34;1100288003001.0
Rondônia;Área 002;29320;29320;29273;47;0;1100288003002.0
Rondônia;Vilhena;76202;76063;76025;38;139;1100304.0
Rondônia;Área 001;14634;14609;14609;0;25;1100304003001.0
Rondônia;Área 002;25983;25958;25943;15;25;1100304003002.0
Rondônia;Área 003;35585;35496;35473;23;89;1100304003003.0
Acre;Cruzeiro do Sul;78507;78470;78412;58;37;1200203.0
Acre;Área 001;17975;17966;17960;6;9;1200203003001.0
Acre;Área 002;28113;28084;28042;42;29;1200203003002.0
Acre;Área 003;32419;32419;32410;9;0;1200203003003.0
Acre;Rio Branco;336038;335634;335383;251;404;1200401.0
Acre;Área 001;25962;25872;25860;12;90;1200401005001.0
Acre;Área 002;37824;37709;37666;44;115;1200401005002.0
Acre;Área 003;57867;57796;57776;21;71;1200401005003.0
Acre;Área 004;55506;55475;55421;54;31;1200401005004.0
Acre;Área 005;46397;46348;46319;29;49;1200401005005.0
Acre;Área 006;44803;44792;44781;11;11;1200401005006.0
Acre;Área 007;40186;40158;40114;44;28;1200401005007.0
Acre;Área 008;27493;27483;27446;37;10;1200401005008.0
Amazonas;Coari;75965;75840;75804;35;125;1301209.0
Amazonas;Área 001;39911;39911;39911;0;0;1301209003001.0
Amazonas;Área 002;36054;35929;35893;35;125;1301209003002.0
Amazonas;Humaitá;44227;44200;44200;0;27;1301704.0
Amazonas;Área 001;19313;19286;19286;0;27;1301704003001.0
Amazonas;Área 002;24914;24914;24914;0;0;1301704003002.0
Amazonas;Iranduba;40781;40743;40692;52;38;1301852.0
Amazonas;Área 001;18128;18117;18084;33;11;1301852003001.0
Amazonas;Área 002;22653;22626;22607;19;27;1301852003002.0
Amazonas;Itacoatiara;86839;86779;86737;41;60;1301902.0
Amazonas;Área 001;17881;17881;17881;0;0;1301902003001.0
Amazonas;Área 002;34388;34368;34356;12;20;1301902003002.0
Amazonas;Área 003;34570;34530;34500;30;40;1301902003003.0
Amazonas;Manacapuru;85141;85052;85042;10;89;1302504.0
Amazonas;Área 001;19607;19587;19587;0;20;1302504003001.0
Amazonas;Área 002;33775;33767;33767;0;8;1302504003002.0
Amazonas;Área 003;31759;31698;31688;10;61;1302504003003.0
Amazonas;Manaus;1802014;1798773;1797361;1413;3241;1302603.0
Amazonas;Aleixo-Adrianópolis-Nossa Senhora das Graças;44618;44238;43905;333;380;1302603005008.0
Amazonas;Alvorada;64621;64504;64492;12;117;1302603005005.0
Amazonas;Armando Mendes-Zumbi dos Palmares;63447;63428;63411;17;19;1302603005009.0
Amazonas;Betânia-Crespo-São Lázaro-Vila Buriti;40158;40115;40115;0;43;1302603005020.0
Amazonas;Cachoeirinha-Praça 14 de Janeiro-Raiz;41320;41267;41229;38;53;1302603005010.0
Amazonas;Centro-Nossa Senhora Aparecida;38654;38328;38208;120;326;1302603005011.0
Amazonas;Cidade de Deus;70142;69968;69968;0;174;1302603005006.0
Amazonas;Cidade Nova;121135;120972;120972;0;163;1302603005007.0
Amazonas;Colônia Oliveira Machado-Educandos-Santa Luzia, Morro da Liberdade;42775;42775;42775;0;0;1302603005003.0
Amazonas;Colônia Santo Antônio-Novo Israel;34461;34447;34235;213;14;1302603005024.0
Amazonas;Colônia Terra Nova;45076;45054;45008;46;22;1302603005025.0
Amazonas;Compensa;75832;75781;75723;59;51;1302603005004.0
Amazonas;Coroado;51354;51299;51282;17;55;1302603005019.0
Amazonas;Distrito Industrial I-Distrito Industrial Ii-Puraquequara-Colônia Antônio Aleixo-Mauazinho;52625;52625;52625;0;0;1302603005002.0
Amazonas;Dom Pedro I-São Geraldo-Chapada;35851;35720;35635;86;131;1302603005012.0
Amazonas;Flores;48098;47891;47865;26;207;1302603005021.0
Amazonas;Gilberto Mestrinho;55347;55325;55325;0;22;1302603005032.0
Amazonas;Glória-Santo Antônio-São Raimundo-Presidente-Vargas;53602;53539;53539;0;63;1302603005013.0
Amazonas;Japiim;53370;53232;53187;45;138;1302603005018.0
Amazonas;Jorge Teixeira;112879;112870;112848;22;9;1302603005029.0
Amazonas;Lago Azul-Santa Etelvina;33892;33839;33839;0;53;1302603005001.0
Amazonas;Lírio do Vale-Planalto-Ponta Negra;42824;42505;42372;133;319;1302603005015.0
Amazonas;Monte das Oliveiras;40162;40162;40135;27;0;1302603005023.0
Amazonas;Nova Cidade;59576;59551;59551;0;25;1302603005031.0
Amazonas;Nova Esperança-Santo Agostinho;34289;34289;34270;19;0;1302603005014.0
Amazonas;Novo Aleixo;96611;96553;96532;21;58;1302603005030.0
Amazonas;Parque 10 de Novembro;41256;40845;40717;128;411;1302603005022.0
Amazonas;Redenção-Da Paz;50359;50264;50264;0;95;1302603005016.0
Amazonas;São Francisco-Petrópolis;58034;57821;57821;0;213;1302603005017.0
Amazonas;São Jorge-Vila da Prata;32684;32684;32684;0;0;1302603005033.0
Amazonas;São José Operário;66625;66594;66594;0;31;1302603005027.0
Amazonas;Tancredo Neves;48377;48352;48352;0;25;1302603005028.0
Amazonas;Tarumã-Tarumã-Açu-Manaus (demais Setores);51960;51936;51884;52;24;1302603005026.0
Amazonas;Manicoré;47017;47017;47008;9;0;1302702.0
Amazonas;Área 001;22495;22495;22495;0;0;1302702003001.0
Amazonas;Área 002;24522;24522;24513;9;0;1302702003002.0
Amazonas;Parintins;102033;102009;101974;35;24;1303403.0
Amazonas;Área 001;20303;20291;20291;0;12;1303403003001.0
Amazonas;Área 002;38011;38000;37981;19;11;1303403003002.0
Amazonas;Área 003;43719;43719;43702;17;0;1303403003003.0
Amazonas;Tefé;61453;61386;61321;65;67;1304203.0
Amazonas;Área 001;20713;20705;20705;0;8;1304203003001.0
Amazonas;Área 002;40740;40681;40616;65;59;1304203003002.0
Roraima;Boa Vista;284313;283523;282522;1001;790;1400100.0
Roraima;Área 001;17764;17718;17694;24;46;1400100005001.0
Roraima;Área 002;23518;23500;23465;35;18;1400100005002.0
Roraima;Área 003;26843;26812;26727;85;31;1400100005003.0
Roraima;Área 004;18689;18657;18549;108;32;1400100005004.0
Roraima;Área 005;22543;22461;22423;38;82;1400100005005.0
Roraima;Área 006;16356;16298;16241;57;58;1400100005006.0
Roraima;Área 007;24961;24900;24842;58;61;1400100005007.0
Roraima;Área 008;17400;17390;17348;42;10;1400100005008.0
Roraima;Área 009;22572;22529;22428;101;43;1400100005009.0
Roraima;Área 010;20906;20898;20780;118;8;1400100005010.0
Roraima;Área 011;14093;14044;14010;34;49;1400100005011.0
Roraima;Área 012;22951;22891;22829;63;60;1400100005012.0
Roraima;Área 013;18241;18095;17998;98;146;1400100005013.0
Roraima;Área 014;17476;17329;17189;140;147;1400100005014.0
Pará;Abaetetuba;141100;141040;141030;10;60;1500107.0
Pará;Área 001;21991;21981;21971;10;10;1500107003001.0
Pará;Área 002;19363;19363;19363;0;0;1500107003002.0
Pará;Área 003;29673;29673;29673;0;0;1500107003003.0
Pará;Área 004;35649;35625;35625;0;24;1500107003004.0
Pará;Área 005;34424;34398;34398;0;26;1500107003005.0
Pará;Acará;53569;53516;53516;0;53;1500206.0
Pará;Área 001;19513;19486;19486;0;27;1500206003001.0
Pará;Área 002;34056;34030;34030;0;26;1500206003002.0
Pará;Alenquer;52626;52615;52615;0;11;1500404.0
Pará;Área 001;20540;20529;20529;0;11;1500404003001.0
Pará;Área 002;32086;32086;32086;0;0;1500404003002.0
Pará;Altamira;99075;99023;98994;29;52;1500602.0
Pará;Área 001;16272;16272;16263;9;0;1500602003001.0
Pará;Área 002;16496;16486;16474;12;10;1500602003002.0
Pará;Área 003;17801;17801;17801;0;0;1500602003003.0
Pará;Área 004;17776;17764;17764;0;12;1500602003004.0
Pará;Área 005;30730;30700;30693;8;30;1500602003005.0
Pará;Ananindeua;471980;471506;471327;179;474;1500800.0
Pará;Atalaia e Jaderlandia;39059;39059;39059;0;0;1500800005001.0
Pará;Aurá e Águas Brancas;31913;31913;31913;0;0;1500800005002.0
Pará;Centro Júlia Seffer;34846;34846;34846;0;0;1500800005003.0
Pará;Cidade Nova;50330;50265;50245;20;65;1500800005004.0
Pará;Coqueiro Norte;31310;31250;31250;0;60;1500800005005.0
Pará;Coqueiro Providência;33123;32879;32850;29;244;1500800005006.0
Pará;Guajará-Maguari;32843;32808;32808;0;35;1500800005007.0
Pará;Guanabara e Águas Lindas;36107;36107;36057;50;0;1500800005008.0
Pará;Heliolandia e Geraldo Palmeira;39030;39010;38990;20;20;1500800005009.0
Pará;Icuí;39125;39075;39053;22;50;1500800005010.0
Pará;Jibóia Branca e 40 Horas;39657;39657;39657;0;0;1500800005011.0
Pará;Paar;33811;33811;33811;0;0;1500800005012.0
Pará;Urbanização Restrita;30826;30826;30787;39;0;1500800005013.0
Pará;Augusto Corrêa;40497;40497;40497;0;0;1500909.0
Pará;Área 001;19253;19253;19253;0;0;1500909003001.0
Pará;Área 002;21244;21244;21244;0;0;1500909003002.0
Pará;Barcarena;99859;99849;99821;28;10;1501303.0
Pará;Área 001;30688;30688;30660;28;0;1501303003001.0
Pará;Área 002;32411;32411;32411;0;0;1501303003002.0
Pará;Área 003;36760;36750;36750;0;10;1501303003003.0
Pará;Belém;1393399;1391623;1390946;677;1776;1501402.0
Pará;Agulha;33406;33406;33406;0;0;1501402005040.0
Pará;Área Rural;29525;29525;29512;13;0;1501402005027.0
Pará;Ariri;32511;32466;32466;0;45;1501402005034.0
Pará;Barreiro;33603;33603;33583;20;0;1501402005005.0
Pará;Bengui;33011;33011;33011;0;0;1501402005029.0
Pará;Cabanagem;30886;30886;30886;0;0;1501402005031.0
Pará;Castanheira;30444;30396;30396;0;48;1501402005026.0
Pará;Centro Histórico;29912;29427;29363;64;485;1501402005001.0
Pará;Condor;35145;35124;35104;20;21;1501402005020.0
Pará;Coqueiro;31593;31593;31569;24;0;1501402005033.0
Pará;Cremação;32621;32445;32445;0;176;1501402005017.0
Pará;Cruzeiro;33514;33514;33514;0;0;1501402005041.0
Pará;Guamá-01;34739;34739;34739;0;0;1501402005021.0
Pará;Guamá-02;33971;33971;33971;0;0;1501402005022.0
Pará;Guamá-03;34294;34294;34294;0;0;1501402005023.0
Pará;Jabatiteua;32474;32457;32457;0;17;1501402005025.0
Pará;Jurunas-01;34909;34832;34832;0;77;1501402005018.0
Pará;Jurunas-02;35341;35341;35341;0;0;1501402005019.0
Pará;Maracacuera;32019;32019;31994;25;0;1501402005039.0
Pará;Marambaia;33854;33854;33812;42;0;1501402005008.0
Pará;Marco-01;28821;28724;28630;94;97;1501402005013.0
Pará;Marco-02;30105;29895;29826;69;210;1501402005014.0
Pará;Mosqueiro-Exp;16849;16839;16829;10;10;1501402005044.0
Pará;Mosqueiro-Urb;14545;14531;14531;0;14;1501402005043.0
Pará;Nazaré;28983;28883;28791;92;100;1501402005015.0
Pará;Nova Marambaia;34378;34314;34288;26;64;1501402005007.0
Pará;Outeiro;28645;28635;28625;10;10;1501402005042.0
Pará;Parque Guajará;31009;31009;31009;0;0;1501402005037.0
Pará;Parque Verde;32120;32101;32082;19;19;1501402005032.0
Pará;Pedreira-01;33831;33819;33819;0;12;1501402005010.0
Pará;Pedreira-02;32082;32051;32032;19;31;1501402005011.0
Pará;Pedreira-03;33137;33112;33069;44;25;1501402005012.0
Pará;Pratinha;32228;32212;32212;0;16;1501402005028.0
Pará;Sacramenta;32554;32554;32499;55;0;1501402005004.0
Pará;São Brás;29946;29876;29860;16;70;1501402005016.0
Pará;São Clemente;33463;33463;33463;0;0;1501402005030.0
Pará;Souza;30880;30830;30830;0;50;1501402005009.0
Pará;Tapanã-01;31282;31237;31237;0;45;1501402005035.0
Pará;Tapanã-02;33056;33056;33056;0;0;1501402005036.0
Pará;Telégrafo;35944;35944;35944;0;0;1501402005003.0
Pará;Tenoné;31607;31607;31607;0;0;1501402005038.0
Pará;Terra Firme;34468;34468;34468;0;0;1501402005024.0
Pará;Umarizal;31901;31767;31751;16;134;1501402005002.0
Pará;Val-de-Cães;33793;33793;33793;0;0;1501402005006.0
Pará;Benevides;51651;51641;51641;0;10;1501501.0
Pará;Distrito 05 de Benevides;29060;29050;29050;0;10;1501501002001.0
Pará;Distrito 10 de Benevides;22591;22591;22591;0;0;1501501002002.0
Pará;Bragança;113227;113215;113208;8;12;1501709.0
Pará;Área 001;17339;17339;17339;0;0;1501709003001.0
Pará;Área 002;29086;29086;29086;0;0;1501709003002.0
Pará;Área 003;27140;27128;27121;8;12;1501709003003.0
Pará;Área 004;39662;39662;39662;0;0;1501709003004.0
Pará;Breu Branco;52493;52493;52493;0;0;1501782.0
Pará;Área 001;32344;32344;32344;0;0;1501782003001.0
Pará;Área 002;20149;20149;20149;0;0;1501782003002.0
Pará;Breves;92860;92850;92850;0;10;1501808.0
Pará;Área 001;20089;20079;20079;0;10;1501808003001.0
Pará;Área 002;39394;39394;39394;0;0;1501808003002.0
Pará;Área 003;33377;33377;33377;0;0;1501808003003.0
Pará;Cametá;120896;120881;120881;0;15;1502103.0
Pará;Área 001;21071;21071;21071;0;0;1502103003001.0
Pará;Área 002;22409;22409;22409;0;0;1502103003002.0
Pará;Área 003;34151;34136;34136;0;15;1502103003003.0
Pará;Área 004;43265;43265;43265;0;0;1502103003004.0
Pará;Capanema;63639;63631;63610;21;8;1502202.0
Pará;Área 001;30296;30296;30285;11;0;1502202003001.0
Pará;Área 002;33343;33335;33326;10;8;1502202003002.0
Pará;Capitão Poço;51893;51882;51882;0;11;1502301.0
Pará;Área 001;27914;27903;27903;0;11;1502301003001.0
Pará;Área 002;23979;23979;23979;0;0;1502301003002.0
Pará;Castanhal;173149;173037;172919;118;112;1502400.0
Pará;Área 001;19482;19475;19475;0;7;1502400003001.0
Pará;Área 002;15850;15790;15779;12;60;1502400003002.0
Pará;Área 003;17091;17091;17091;0;0;1502400003003.0
Pará;Área 004;17330;17330;17330;0;0;1502400003004.0
Pará;Área 005;15260;15260;15260;0;0;1502400003005.0
Pará;Área 006;16882;16882;16841;41;0;1502400003006.0
Pará;Área 007;32263;32218;32164;54;45;1502400003007.0
Pará;Área 008;38991;38991;38979;12;0;1502400003008.0
Pará;Conceição do Araguaia;45557;45510;45494;16;47;1502707.0
Pará;Área 001;20564;20538;20538;0;26;1502707003001.0
Pará;Área 002;24993;24971;24955;16;22;1502707003002.0
Pará;Dom Eliseu;51319;51301;51252;48;18;1502939.0
Pará;Área 001;19042;19042;18994;48;0;1502939003001.0
Pará;Área 002;32277;32259;32259;0;18;1502939003002.0
Pará;Igarapé-Açu;35887;35887;35866;21;0;1503200.0
Pará;Área 001;17421;17421;17409;12;0;1503200003001.0
Pará;Área 002;18466;18466;18457;9;0;1503200003002.0
Pará;Igarapé-Miri;58077;58077;58077;0;0;1503309.0
Pará;Distrito 05 de Igarapé-Miri;35195;35195;35195;0;0;1503309002001.0
Pará;Distrito 10 de Igarapé-Miri;22882;22882;22882;0;0;1503309002002.0
Pará;Ipixuna do Pará;51309;51309;51309;0;0;1503457.0
Pará;Área 001;17947;17947;17947;0;0;1503457003001.0
Pará;Área 002;33362;33362;33362;0;0;1503457003002.0
Pará;Itaituba;97493;97471;97450;21;22;1503606.0
Pará;Área 001;21116;21116;21103;13;0;1503606003001.0
Pará;Área 002;20206;20198;20198;0;8;1503606003002.0
Pará;Área 003;17323;17309;17309;0;14;1503606003003.0
Pará;Área 004;38848;38848;38839;9;0;1503606003004.0
Pará;Itupiranga;51220;51213;51213;0;7;1503705.0
Pará;Área 001;20490;20483;20483;0;7;1503705003001.0
Pará;Área 002;30730;30730;30730;0;0;1503705003002.0
Pará;Jacundá;51360;51335;51335;0;25;1503804.0
Pará;Área 001;17958;17958;17958;0;0;1503804003001.0
Pará;Área 002;33402;33377;33377;0;25;1503804003002.0
Pará;Juruti;47086;47062;47062;0;24;1503903.0
Pará;Área 001;26073;26061;26061;0;12;1503903003001.0
Pará;Área 002;21013;21001;21001;0;12;1503903003002.0
Pará;Marabá;233669;233580;233580;0;89;1504208.0
Pará;Cidade Nova;80743;80687;80687;0;56;1504208005002.0
Pará;Interior;34742;34742;34742;0;0;1504208005004.0
Pará;Morada Nova;24362;24362;24362;0;0;1504208005003.0
Pará;Nova e Velha Maraba;93822;93789;93789;0;33;1504208005001.0
Pará;Marituba;108246;108232;108224;8;14;1504422.0
Pará;Área 001;31313;31300;31300;0;13;1504422003001.0
Pará;Área 002;39283;39282;39282;0;1;1504422003002.0
Pará;Área 003;37650;37650;37642;8;0;1504422003003.0
Pará;Moju;70018;70018;70018;0;0;1504703.0
Pará;Área 001;27514;27514;27514;0;0;1504703003001.0
Pará;Área 002;42504;42504;42504;0;0;1504703003002.0
Pará;Monte Alegre;55462;55451;55445;6;11;1504802.0
Pará;Área 001;23467;23456;23450;6;11;1504802003001.0
Pará;Área 002;31995;31995;31995;0;0;1504802003002.0
Pará;Novo Repartimento;62050;62037;62032;5;13;1505064.0
Pará;Área 001;30643;30630;30630;0;13;1505064003001.0
Pará;Área 002;31407;31407;31402;5;0;1505064003002.0
Pará;Óbidos;49333;49324;49324;0;9;1505106.0
Pará;Área 001;19555;19546;19546;0;9;1505106003001.0
Pará;Área 002;29778;29778;29778;0;0;1505106003002.0
Pará;Oriximiná;62794;62759;62750;9;35;1505304.0
Pará;Área 001;25240;25205;25196;9;35;1505304003001.0
Pará;Área 002;37554;37554;37554;0;0;1505304003002.0
Pará;Pacajá;39979;39979;39979;0;0;1505486.0
Pará;Área 001;16832;16832;16832;0;0;1505486003001.0
Pará;Área 002;23147;23147;23147;0;0;1505486003002.0
Pará;Paragominas;97819;97819;97819;0;0;1505502.0
Pará;Área 001;17042;17042;17042;0;0;1505502003001.0
Pará;Área 002;16026;16026;16026;0;0;1505502003002.0
Pará;Área 003;25383;25383;25383;0;0;1505502003003.0
Pará;Área 004;39368;39368;39368;0;0;1505502003004.0
Pará;Parauapebas;153908;153880;153816;64;28;1505536.0
Pará;Área 001;14660;14652;14629;23;8;1505536003001.0
Pará;Área 002;23812;23812;23812;0;0;1505536003002.0
Pará;Área 003;15939;15939;15939;0;0;1505536003003.0
Pará;Área 004;14001;14001;14001;0;0;1505536003004.0
Pará;Área 005;21647;21647;21647;0;0;1505536003005.0
Pará;Área 006;24348;24339;24317;21;9;1505536003006.0
Pará;Área 007;39501;39491;39471;20;10;1505536003007.0
Pará;Portel;52172;52172;52172;0;0;1505809.0
Pará;Área 001;22108;22108;22108;0;0;1505809003001.0
Pará;Área 002;30064;30064;30064;0;0;1505809003002.0
Pará;Redenção;75556;75553;75531;23;3;1506138.0
Pará;Área 001;19374;19374;19374;0;0;1506138003001.0
Pará;Área 002;19858;19855;19843;12;3;1506138003002.0
Pará;Área 003;36324;36324;36314;10;0;1506138003003.0
Pará;Rondon do Pará;46964;46953;46943;10;11;1506187.0
Pará;Área 001;21847;21847;21847;0;0;1506187003001.0
Pará;Área 002;25117;25106;25096;10;11;1506187003002.0
Pará;Rurópolis;40087;40087;40087;0;0;1506195.0
Pará;Área 001;18984;18984;18984;0;0;1506195003001.0
Pará;Área 002;21103;21103;21103;0;0;1506195003002.0
Pará;Santa Isabel do Pará;59466;59420;59409;12;46;1506500.0
Pará;Área 001;25642;25606;25606;0;36;1506500003001.0
Pará;Área 002;33824;33814;33802;12;10;1506500003002.0
Pará;Santana do Araguaia;56153;56153;56131;22;0;1506708.0
Pará;Área 001;20852;20852;20852;0;0;1506708003001.0
Pará;Área 002;35301;35301;35279;22;0;1506708003002.0
Pará;Santarém;294580;294493;294446;47;87;1506807.0
Pará;Grande Área da Aldeia I;24977;24954;24954;0;23;1506807005001.0
Pará;Grande Área da Aldeia II;38145;38122;38092;30;23;1506807005002.0
Pará;Grande Área da Nova República;30961;30961;30961;0;0;1506807005003.0
Pará;Grande Área da Prainha I;29333;29321;29321;0;12;1506807005004.0
Pará;Grande Área da Prainha II;28791;28781;28772;9;10;1506807005005.0
Pará;Grande Área do Maicá;21801;21792;21792;0;9;1506807005006.0
Pará;Grande Área do Santarenzinho;31157;31157;31157;0;0;1506807005007.0
Pará;Microbacia do Rio Amazonas e Eixo Forte;21116;21116;21116;0;0;1506807005008.0
Pará;Microbacias do Lago Grande e Tapajós;32454;32454;32454;0;0;1506807005009.0
Pará;Mojuí dos Campos;15968;15957;15957;0;11;1506807005010.0
Pará;Planalto;19877;19877;19869;8;0;1506807005011.0
Pará;São Félix do Xingu;91340;91328;91316;12;12;1507300.0
Pará;Área 001;16590;16590;16590;0;0;1507300003001.0
Pará;Área 002;17040;17040;17040;0;0;1507300003002.0
Pará;Área 003;22446;22446;22434;12;0;1507300003003.0
Pará;Área 004;35264;35252;35252;0;12;1507300003004.0
Pará;São Miguel do Guamá;51567;51545;51545;0;22;1507607.0
Pará;Área 001;25055;25033;25033;0;22;1507607003001.0
Pará;Área 002;26512;26512;26512;0;0;1507607003002.0
Pará;Tailândia;79297;79285;79277;8;12;1507953.0
Pará;Área 001;38131;38131;38131;0;0;1507953003001.0
Pará;Área 002;41166;41154;41146;8;12;1507953003002.0
Pará;Tomé-Açu;56518;56436;56381;55;82;1508001.0
Pará;Área 001;18353;18271;18216;55;82;1508001003001.0
Pará;Área 002;38165;38165;38165;0;0;1508001003002.0
Pará;Tucumã;33690;33666;33666;0;24;1508084.0
Pará;Área 001;14857;14842;14842;0;15;1508084003001.0
Pará;Área 002;18833;18824;18824;0;9;1508084003002.0
Pará;Tucuruí;97128;97128;97117;11;0;1508100.0
Pará;Área 001;19080;19080;19080;0;0;1508100003001.0
Pará;Área 002;23458;23458;23458;0;0;1508100003002.0
Pará;Área 003;27425;27425;27414;11;0;1508100003003.0
Pará;Área 004;27165;27165;27165;0;0;1508100003004.0
Pará;Uruará;44789;44789;44789;0;0;1508159.0
Pará;Área 001;21967;21967;21967;0;0;1508159003001.0
Pará;Área 002;22822;22822;22822;0;0;1508159003002.0
Pará;Vigia;47889;47889;47875;14;0;1508209.0
Pará;Área 001;16495;16495;16495;0;0;1508209003001.0
Pará;Área 002;31394;31394;31380;14;0;1508209003002.0
Pará;Viseu;56716;56716;56716;0;0;1508308.0
Pará;Área 001;19891;19891;19891;0;0;1508308003001.0
Pará;Área 002;36825;36825;36825;0;0;1508308003002.0
Pará;Xinguara;40573;40565;40526;39;8;1508407.0
Pará;Área 001;15134;15134;15134;0;0;1508407003001.0
Pará;Área 002;25439;25431;25392;39;8;1508407003002.0
Amapá;Macapá;398204;397926;397604;322;278;1600303.0
Amapá;Área 001;23904;23893;23882;11;11;1600303005001.0
Amapá;Área 002;20809;20802;20762;40;7;1600303005002.0
Amapá;Área 003;18826;18816;18816;0;10;1600303005003.0
Amapá;Área 004;17260;17222;17222;0;38;1600303005004.0
Amapá;Área 005;18373;18373;18371;2;0;1600303005005.0
Amapá;Área 006;22599;22575;22554;21;24;1600303005006.0
Amapá;Área 007;20326;20318;20298;20;8;1600303005007.0
Amapá;Área 008;17892;17892;17865;27;0;1600303005008.0
Amapá;Área 009;19096;19096;19080;16;0;1600303005009.0
Amapá;Área 010;18519;18455;18422;33;64;1600303005010.0
Amapá;Área 011;20039;20039;20039;0;0;1600303005011.0
Amapá;Área 012;20011;19990;19981;9;21;1600303005012.0
Amapá;Área 013;25567;25538;25517;21;29;1600303005013.0
Amapá;Área 014;17989;17989;17989;0;0;1600303005014.0
Amapá;Área 015;18007;18007;18007;0;0;1600303005015.0
Amapá;Área 016;20707;20664;20634;31;43;1600303005016.0
Amapá;Área 017;25394;25392;25369;23;2;1600303005017.0
Amapá;Área 018;20471;20450;20424;26;21;1600303005018.0
Amapá;Área 019;32415;32415;32374;41;0;1600303005019.0
Amapá;Santana;101262;101207;101160;47;55;1600600.0
Amapá;Área 001;19282;19250;19250;0;32;1600600003001.0
Amapá;Área 002;38471;38457;38436;21;14;1600600003002.0
Amapá;Área 003;43509;43500;43474;26;9;1600600003003.0
Tocantins;Araguaína;150484;150426;150381;46;58;1702109.0
Tocantins;Área 001;23333;23333;23315;18;0;1702109003001.0
Tocantins;Área 002;16003;15995;15995;0;8;1702109003002.0
Tocantins;Área 003;15063;15056;15049;8;7;1702109003003.0
Tocantins;Área 004;13552;13552;13546;6;0;1702109003004.0
Tocantins;Área 005;26926;26926;26926;0;0;1702109003005.0
Tocantins;Área 006;22438;22416;22402;14;22;1702109003006.0
Tocantins;Área 007;33169;33148;33148;0;21;1702109003007.0
Tocantins;Colinas do Tocantins;30838;30815;30788;27;23;1705508.0
Tocantins;Área 001;14096;14073;14046;27;23;1705508003001.0
Tocantins;Área 002;16742;16742;16742;0;0;1705508003002.0
Tocantins;Gurupi;76755;76720;76688;32;35;1709500.0
Tocantins;Área 001;14306;14290;14268;22;16;1709500003001.0
Tocantins;Área 002;16122;16111;16111;0;11;1709500003002.0
Tocantins;Área 003;18006;18006;17996;10;0;1709500003003.0
Tocantins;Área 004;28321;28313;28313;0;8;1709500003004.0
Tocantins;Palmas;228332;228131;228037;94;201;1721000.0
Tocantins;Arne;17369;17308;17283;25;61;1721000005001.0
Tocantins;Arno;37170;37134;37105;29;36;1721000005002.0
Tocantins;Arse 1;17383;17360;17349;11;23;1721000005003.0
Tocantins;Arse 2;41311;41281;41259;22;30;1721000005004.0
Tocantins;Arso;20723;20682;20682;0;41;1721000005005.0
Tocantins;Extra Cidade;15984;15984;15984;0;0;1721000005010.0
Tocantins;Sul 1;19488;19477;19477;0;11;1721000005006.0
Tocantins;Sul 2;23373;23373;23373;0;0;1721000005007.0
Tocantins;Sul 3;16797;16797;16797;0;0;1721000005008.0
Tocantins;Sul 4;18734;18734;18727;7;0;1721000005009.0
Tocantins;Paraíso do Tocantins;44417;44417;44407;10;0;1716109.0
Tocantins;Área 001;21935;21935;21935;0;0;1716109003001.0
Tocantins;Área 002;22482;22482;22472;10;0;1716109003002.0
Tocantins;Porto Nacional;49146;49137;49127;9;9;1718204.0
Tocantins;Área 001;24492;24492;24492;0;0;1718204003001.0
Tocantins;Área 002;24654;24645;24635;9;9;1718204003002.0
Maranhão;Açailândia;104047;104018;104018;0;29;2100055.0
Maranhão;Área 001;17814;17814;17814;0;0;2100055003001.0
Maranhão;Área 002;17575;17575;17575;0;0;2100055003002.0
Maranhão;Área 003;25844;25844;25844;0;0;2100055003003.0
Maranhão;Área 004;42814;42785;42785;0;29;2100055003004.0
Maranhão;Bacabal;100014;100007;100007;0;7;2101202.0
Maranhão;Área 001;15532;15525;15525;0;7;2101202003001.0
Maranhão;Área 002;17881;17881;17881;0;0;2101202003002.0
Maranhão;Área 003;30361;30361;30361;0;0;2101202003003.0
Maranhão;Área 004;36240;36240;36240;0;0;2101202003004.0
Maranhão;Balsas;83528;83528;83490;38;0;2101400.0
Maranhão;Área 001;29307;29307;29283;24;0;2101400003001.0
Maranhão;Área 002;19526;19526;19512;14;0;2101400003002.0
Maranhão;Área 003;34695;34695;34695;0;0;2101400003003.0
Maranhão;Barra do Corda;82830;82830;82821;9;0;2101608.0
Maranhão;Área 001;16751;16751;16751;0;0;2101608003001.0
Maranhão;Área 002;33325;33325;33325;0;0;2101608003002.0
Maranhão;Área 003;32754;32754;32745;9;0;2101608003003.0
Maranhão;Barreirinhas;54930;54930;54930;0;0;2101707.0
Maranhão;Área 001;22355;22355;22355;0;0;2101707003001.0
Maranhão;Área 002;32575;32575;32575;0;0;2101707003002.0
Maranhão;Bom Jardim;39049;39049;39040;9;0;2102002.0
Maranhão;Área 001;18944;18944;18944;0;0;2102002003001.0
Maranhão;Área 002;20105;20105;20096;9;0;2102002003002.0
Maranhão;Buriticupu;65237;65237;65237;0;0;2102325.0
Maranhão;Área 001;22870;22870;22870;0;0;2102325003001.0
Maranhão;Área 002;42367;42367;42367;0;0;2102325003002.0
Maranhão;Caxias;155129;155126;155126;0;3;2103000.0
Maranhão;Área 001;17917;17917;17917;0;0;2103000003001.0
Maranhão;Área 002;20630;20627;20627;0;3;2103000003002.0
Maranhão;Área 003;16418;16418;16418;0;0;2103000003003.0
Maranhão;Área 004;15197;15197;15197;0;0;2103000003004.0
Maranhão;Área 005;17339;17339;17339;0;0;2103000003005.0
Maranhão;Área 006;33261;33261;33261;0;0;2103000003006.0
Maranhão;Área 007;34367;34367;34367;0;0;2103000003007.0
Maranhão;Chapadinha;73350;73333;73333;0;17;2103208.0
Maranhão;Área 001;34660;34660;34660;0;0;2103208003001.0
Maranhão;Área 002;38690;38673;38673;0;17;2103208003002.0
Maranhão;Codó;118038;118015;118015;0;23;2103307.0
Maranhão;Área 001;19662;19662;19662;0;0;2103307003001.0
Maranhão;Área 002;29244;29244;29244;0;0;2103307003002.0
Maranhão;Área 003;31560;31547;31547;0;13;2103307003003.0
Maranhão;Área 004;37572;37563;37563;0;9;2103307003004.0
Maranhão;Coelho Neto;46750;46750;46750;0;0;2103406.0
Maranhão;Área 001;20676;20676;20676;0;0;2103406003001.0
Maranhão;Área 002;26074;26074;26074;0;0;2103406003002.0
Maranhão;Colinas;39132;39132;39132;0;0;2103505.0
Maranhão;Área 001;18562;18562;18562;0;0;2103505003001.0
Maranhão;Área 002;20570;20570;20570;0;0;2103505003002.0
Maranhão;Coroatá;61725;61715;61715;0;10;2103604.0
Maranhão;Área 001;20871;20871;20871;0;0;2103604003001.0
Maranhão;Área 002;40854;40844;40844;0;10;2103604003002.0
Maranhão;Cururupu;32652;32652;32652;0;0;2103703.0
Maranhão;Área 001;15632;15632;15632;0;0;2103703003001.0
Maranhão;Área 002;17020;17020;17020;0;0;2103703003002.0
Maranhão;Estreito;35835;35823;35823;0;12;2104057.0
Maranhão;Área 001;16455;16455;16455;0;0;2104057003001.0
Maranhão;Área 002;19380;19368;19368;0;12;2104057003002.0
Maranhão;Grajaú;62093;62093;62084;9;0;2104800.0
Maranhão;Área 001;26334;26334;26325;9;0;2104800003001.0
Maranhão;Área 002;35759;35759;35759;0;0;2104800003002.0
Maranhão;Imperatriz;247505;247399;247361;37;106;2105302.0
Maranhão;Área 001;15130;15120;15120;0;10;2105302004001.0
Maranhão;Área 002;14989;14979;14960;19;10;2105302004002.0
Maranhão;Área 003;14988;14974;14974;0;14;2105302004003.0
Maranhão;Área 004;13873;13851;13833;19;22;2105302004004.0
Maranhão;Área 005;17852;17852;17852;0;0;2105302004005.0
Maranhão;Área 006;18209;18209;18209;0;0;2105302004006.0
Maranhão;Área 007;18964;18942;18942;0;22;2105302004007.0
Maranhão;Área 008;22114;22106;22106;0;8;2105302004008.0
Maranhão;Área 009;25513;25513;25513;0;0;2105302004009.0
Maranhão;Área 010;20623;20623;20623;0;0;2105302004010.0
Maranhão;Área 011;29556;29535;29535;0;21;2105302004011.0
Maranhão;Área 012;35694;35694;35694;0;0;2105302004012.0
Maranhão;Itapecuru Mirim;62110;62110;62110;0;0;2105401.0
Maranhão;Área 001;25226;25226;25226;0;0;2105401003001.0
Maranhão;Área 002;36884;36884;36884;0;0;2105401003002.0
Maranhão;Lago da Pedra;46083;46043;46034;9;40;2105708.0
Maranhão;Área 001;20801;20801;20792;9;0;2105708003001.0
Maranhão;Área 002;25282;25242;25242;0;40;2105708003002.0
Maranhão;Paço do Lumiar;105121;105095;105095;0;26;2107506.0
Maranhão;Área 001;15110;15110;15110;0;0;2107506003001.0
Maranhão;Área 002;34638;34612;34612;0;26;2107506003002.0
Maranhão;Área 003;25728;25728;25728;0;0;2107506003003.0
Maranhão;Área 004;29645;29645;29645;0;0;2107506003004.0
Maranhão;Parnarama;34586;34586;34586;0;0;2107803.0
Maranhão;Área 001;16404;16404;16404;0;0;2107803003001.0
Maranhão;Área 002;18182;18182;18182;0;0;2107803003002.0
Maranhão;Pedreiras;39448;39448;39448;0;0;2108207.0
Maranhão;Área 001;15011;15011;15011;0;0;2108207003001.0
Maranhão;Área 002;24437;24437;24437;0;0;2108207003002.0
Maranhão;Pinheiro;78162;78150;78150;0;12;2108603.0
Maranhão;Área 001;19406;19394;19394;0;12;2108603003001.0
Maranhão;Área 002;26197;26197;26197;0;0;2108603003002.0
Maranhão;Área 003;32559;32559;32559;0;0;2108603003003.0
Maranhão;Presidente Dutra;44731;44719;44689;29;12;2109106.0
Maranhão;Área 001;24094;24082;24069;13;12;2109106003001.0
Maranhão;Área 002;20637;20637;20620;17;0;2109106003002.0
Maranhão;Rosário;39576;39576;39576;0;0;2109601.0
Maranhão;Área 001;17374;17374;17374;0;0;2109601003001.0
Maranhão;Área 002;22202;22202;22202;0;0;2109601003002.0
Maranhão;Santa Helena;39110;39110;39110;0;0;2109809.0
Maranhão;Área 001;19616;19616;19616;0;0;2109809003001.0
Maranhão;Área 002;19494;19494;19494;0;0;2109809003002.0
Maranhão;Santa Inês;77282;77282;77282;0;0;2109908.0
Maranhão;Área 001;16570;16570;16570;0;0;2109908003001.0
Maranhão;Área 002;28105;28105;28105;0;0;2109908003002.0
Maranhão;Área 003;32607;32607;32607;0;0;2109908003003.0
Maranhão;Santa Luzia;74043;74043;74043;0;0;2110005.0
Maranhão;Área 001;20869;20869;20869;0;0;2110005003001.0
Maranhão;Área 002;22249;22249;22249;0;0;2110005003002.0
Maranhão;Área 003;30925;30925;30925;0;0;2110005003003.0
Maranhão;São Bento;40736;40736;40736;0;0;2110500.0
Maranhão;Área 001;18615;18615;18615;0;0;2110500003001.0
Maranhão;Área 002;22121;22121;22121;0;0;2110500003002.0
Maranhão;São Domingos do Maranhão;33607;33607;33607;0;0;2110708.0
Maranhão;Área 001;15868;15868;15868;0;0;2110708003001.0
Maranhão;Área 002;17739;17739;17739;0;0;2110708003002.0
Maranhão;São José de Ribamar;163045;163045;163035;10;0;2111201.0
Maranhão;Área 001;19418;19418;19418;0;0;2111201003001.0
Maranhão;Área 002;21158;21158;21158;0;0;2111201003002.0
Maranhão;Área 003;18293;18293;18293;0;0;2111201003003.0
Maranhão;Área 004;15696;15696;15696;0;0;2111201003004.0
Maranhão;Área 005;15970;15970;15970;0;0;2111201003005.0
Maranhão;Área 006;36667;36667;36657;10;0;2111201003006.0
Maranhão;Área 007;35843;35843;35843;0;0;2111201003007.0
Maranhão;São Luís;1014837;1014202;1014000;202;635;2111300.0
Maranhão;Angelim;40788;40743;40683;60;45;2111300005007.0
Maranhão;Anil;38628;38628;38628;0;0;2111300005006.0
Maranhão;Anjo da Guarda;36276;36276;36276;0;0;2111300005022.0
Maranhão;Bairro de Fátima;32542;32542;32542;0;0;2111300005003.0
Maranhão;Centro;31884;31805;31791;14;79;2111300005001.0
Maranhão;Cidade Olímpica;35435;35435;35435;0;0;2111300005029.0
Maranhão;Cidade Operária;39058;39020;39020;0;38;2111300005027.0
Maranhão;Cohab;32870;32843;32843;0;27;2111300005015.0
Maranhão;Cohama;40540;40540;40512;28;0;2111300005008.0
Maranhão;Cohatrac;30978;30846;30803;43;132;2111300005014.0
Maranhão;Coroadinho;32946;32946;32946;0;0;2111300005019.0
Maranhão;Itapiracó;30594;30551;30551;0;43;2111300005013.0
Maranhão;Jardim América;38654;38654;38654;0;0;2111300005028.0
Maranhão;João Paulo;37707;37677;37677;0;30;2111300005004.0
Maranhão;Litoral;33644;33513;33482;31;131;2111300005011.0
Maranhão;Maracanã;38361;38361;38361;0;0;2111300005023.0
Maranhão;Mauro Fecury;33681;33681;33681;0;0;2111300005021.0
Maranhão;Monte Castelo;31700;31700;31700;0;0;2111300005002.0
Maranhão;Sacavém;31819;31819;31819;0;0;2111300005018.0
Maranhão;Santo Antônio;29832;29832;29832;0;0;2111300005017.0
Maranhão;São Cristóvão;36227;36227;36227;0;0;2111300005016.0
Maranhão;São Francisco;36571;36524;36524;0;47;2111300005010.0
Maranhão;São Raimundo;31657;31657;31657;0;0;2111300005025.0
Maranhão;Tibiri;34498;34498;34498;0;0;2111300005024.0
Maranhão;Tirirical;30310;30310;30310;0;0;2111300005026.0
Maranhão;Turu;37553;37534;37534;0;19;2111300005012.0
Maranhão;Vila Embratel;45170;45170;45170;0;0;2111300005020.0
Maranhão;Vila Palmeira;34597;34597;34597;0;0;2111300005005.0
Maranhão;Vinhais;30317;30272;30247;25;45;2111300005009.0
Maranhão;São Mateus do Maranhão;39093;39093;39093;0;0;2111508.0
Maranhão;Área 001;16831;16831;16831;0;0;2111508003001.0
Maranhão;Área 002;22262;22262;22262;0;0;2111508003002.0
Maranhão;Timon;155460;155446;155446;0;14;2112209.0
Maranhão;Área 001;17749;17749;17749;0;0;2112209003001.0
Maranhão;Área 002;17379;17379;17379;0;0;2112209003002.0
Maranhão;Área 003;16887;16887;16887;0;0;2112209003003.0
Maranhão;Área 004;21725;21725;21725;0;0;2112209003004.0
Maranhão;Área 005;18327;18313;18313;0;14;2112209003005.0
Maranhão;Área 006;31055;31055;31055;0;0;2112209003006.0
Maranhão;Área 007;32338;32338;32338;0;0;2112209003007.0
Maranhão;Tuntum;39183;39171;39171;0;12;2112308.0
Maranhão;Área 001;19803;19791;19791;0;12;2112308003001.0
Maranhão;Área 002;19380;19380;19380;0;0;2112308003002.0
Maranhão;Tutóia;52788;52788;52775;13;0;2112506.0
Maranhão;Área 001;25378;25378;25378;0;0;2112506003001.0
Maranhão;Área 002;27410;27410;27397;13;0;2112506003002.0
Maranhão;Vargem Grande;49412;49407;49407;0;5;2112704.0
Maranhão;Área 001;19775;19775;19775;0;0;2112704003001.0
Maranhão;Área 002;29637;29632;29632;0;5;2112704003002.0
Maranhão;Viana;49496;49496;49496;0;0;2112803.0
Maranhão;Área 001;18483;18483;18483;0;0;2112803003001.0
Maranhão;Área 002;31013;31013;31013;0;0;2112803003002.0
Maranhão;Zé Doca;50173;50152;50152;0;21;2114007.0
Maranhão;Área 001;21255;21255;21255;0;0;2114007003001.0
Maranhão;Área 002;28918;28897;28897;0;21;2114007003002.0
Piauí;Altos;38822;38822;38822;0;0;2200400.0
Piauí;Área 001;15189;15189;15189;0;0;2200400003001.0
Piauí;Área 002;23633;23633;23633;0;0;2200400003002.0
Piauí;Barras;44850;44837;44837;0;13;2201200.0
Piauí;Área 001;18429;18429;18429;0;0;2201200003001.0
Piauí;Área 002;26421;26408;26408;0;13;2201200003002.0
Piauí;Campo Maior;45177;45164;45154;10;13;2202208.0
Piauí;Área 001;16207;16194;16194;0;13;2202208003001.0
Piauí;Área 002;28970;28970;28960;10;0;2202208003002.0
Piauí;Esperantina;37767;37767;37767;0;0;2203701.0
Piauí;Área 001;16579;16579;16579;0;0;2203701003001.0
Piauí;Área 002;21188;21188;21188;0;0;2203701003002.0
Piauí;Floriano;57690;57690;57673;17;0;2203909.0
Piauí;Área 001;25292;25292;25275;17;0;2203909003001.0
Piauí;Área 002;32398;32398;32398;0;0;2203909003002.0
Piauí;José de Freitas;37085;37085;37085;0;0;2205508.0
Piauí;Área 001;17533;17533;17533;0;0;2205508003001.0
Piauí;Área 002;19552;19552;19552;0;0;2205508003002.0
Piauí;Oeiras;35640;35640;35640;0;0;2207009.0
Piauí;Área 001;14623;14623;14623;0;0;2207009003001.0
Piauí;Área 002;21017;21017;21017;0;0;2207009003002.0
Piauí;Parnaíba;145705;145641;145610;31;64;2207702.0
Piauí;Área 001;18353;18353;18353;0;0;2207702003001.0
Piauí;Área 002;53593;53555;53549;6;38;2207702003002.0
Piauí;Área 003;17026;17001;16986;15;25;2207702003003.0
Piauí;Área 004;27949;27949;27939;10;0;2207702003004.0
Piauí;Área 005;28784;28784;28784;0;0;2207702003005.0
Piauí;Pedro II;37496;37496;37496;0;0;2207900.0
Piauí;Área 001;16063;16063;16063;0;0;2207900003001.0
Piauí;Área 002;21433;21433;21433;0;0;2207900003002.0
Piauí;Picos;73414;73414;73414;0;0;2208007.0
Piauí;Área 001;14250;14250;14250;0;0;2208007003001.0
Piauí;Área 002;28149;28149;28149;0;0;2208007003002.0
Piauí;Área 003;31015;31015;31015;0;0;2208007003003.0
Piauí;Piripiri;61834;61834;61834;0;0;2208403.0
Piauí;Área 001;16280;16280;16280;0;0;2208403003001.0
Piauí;Área 002;20378;20378;20378;0;0;2208403003002.0
Piauí;Área 003;25176;25176;25176;0;0;2208403003003.0
Piauí;São Raimundo Nonato;32327;32312;32312;0;15;2210607.0
Piauí;Área 001;14005;14005;14005;0;0;2210607003001.0
Piauí;Área 002;18322;18307;18307;0;15;2210607003002.0
Piauí;Teresina;814230;814100;814052;48;130;2211001.0
Piauí;Área 001;31613;31613;31613;0;0;2211001003001.0
Piauí;Área 002;29480;29480;29480;0;0;2211001003002.0
Piauí;Área 003;30137;30137;30137;0;0;2211001003003.0
Piauí;Área 004;31041;31041;31041;0;0;2211001003004.0
Piauí;Área 005;36655;36615;36615;0;40;2211001003005.0
Piauí;Área 006;144458;144458;144458;0;0;2211001003006.0
Piauí;Área 007;124196;124196;124196;0;0;2211001003007.0
Piauí;Área 008;30216;30188;30188;0;28;2211001003008.0
Piauí;Área 009;30709;30709;30709;0;0;2211001003009.0
Piauí;Área 010;33270;33270;33270;0;0;2211001003010.0
Piauí;Área 011;83518;83518;83518;0;0;2211001003011.0
Piauí;Área 012;29226;29226;29212;14;0;2211001003012.0
Piauí;Área 013;33890;33890;33876;14;0;2211001003013.0
Piauí;Área 014;35367;35367;35367;0;0;2211001003014.0
Piauí;Área 015;44844;44844;44844;0;0;2211001003015.0
Piauí;Área 016;65610;65548;65528;20;62;2211001003016.0
Piauí;União;42654;42654;42654;0;0;2211100.0
Piauí;Área 001;16106;16106;16106;0;0;2211100003001.0
Piauí;Área 002;26548;26548;26548;0;0;2211100003002.0
Ceará;Acaraú;57551;57542;57532;10;9;2300200.0
Ceará;Área 001;26115;26106;26096;10;9;2300200003001.0
Ceará;Área 002;31436;31436;31436;0;0;2300200003002.0
Ceará;Acopiara;51160;51160;51160;0;0;2300309.0
Ceará;Área 001;22237;22237;22237;0;0;2300309003001.0
Ceará;Área 002;28923;28923;28923;0;0;2300309003002.0
Ceará;Amontada;39232;39189;39189;0;43;2300754.0
Ceará;Área 001;17620;17577;17577;0;43;2300754003001.0
Ceará;Área 002;21612;21612;21612;0;0;2300754003002.0
Ceará;Aquiraz;72628;72447;72403;43;181;2301000.0
Ceará;Área 001;17098;17032;17019;12;66;2301000003001.0
Ceará;Área 002;24632;24632;24626;6;0;2301000003002.0
Ceará;Área 003;30898;30783;30758;25;115;2301000003003.0
Ceará;Aracati;69159;69018;68997;22;141;2301109.0
Ceará;Área 001;15009;14868;14847;22;141;2301109003001.0
Ceará;Área 002;20859;20859;20859;0;0;2301109003002.0
Ceará;Área 003;33291;33291;33291;0;0;2301109003003.0
Ceará;Barbalha;55323;55316;55316;0;7;2301901.0
Ceará;Área 001;28476;28469;28469;0;7;2301901003001.0
Ceará;Área 002;26847;26847;26847;0;0;2301901003002.0
Ceará;Baturité;33321;33321;33321;0;0;2302107.0
Ceará;Área 001;14702;14702;14702;0;0;2302107003001.0
Ceará;Área 002;18619;18619;18619;0;0;2302107003002.0
Ceará;Beberibe;49311;49267;49267;0;44;2302206.0
Ceará;Área 001;18210;18186;18186;0;24;2302206003001.0
Ceará;Área 002;31101;31082;31082;0;19;2302206003002.0
Ceará;Boa Viagem;52498;52498;52498;0;0;2302404.0
Ceará;Área 001;25680;25680;25680;0;0;2302404003001.0
Ceará;Área 002;26818;26818;26818;0;0;2302404003002.0
Ceará;Brejo Santo;45193;45180;45180;0;13;2302503.0
Ceará;Área 001;17995;17982;17982;0;13;2302503003001.0
Ceará;Área 002;27198;27198;27198;0;0;2302503003002.0
Ceará;Camocim;60158;60158;60144;14;0;2302602.0
Ceará;Área 001;25998;25998;25984;14;0;2302602003001.0
Ceará;Área 002;34160;34160;34160;0;0;2302602003002.0
Ceará;Canindé;74473;74473;74461;12;0;2302800.0
Ceará;Área 001;17997;17997;17985;12;0;2302800003001.0
Ceará;Área 002;28102;28102;28102;0;0;2302800003002.0
Ceará;Área 003;28374;28374;28374;0;0;2302800003003.0
Ceará;Cascavel;66142;66115;66115;0;27;2303501.0
Ceará;Área 001;14790;14781;14781;0;9;2303501003001.0
Ceará;Área 002;19868;19859;19859;0;9;2303501003002.0
Ceará;Área 003;31484;31476;31476;0;8;2303501003003.0
Ceará;Caucaia;325441;325283;325283;0;158;2303709.0
Ceará;Araturi;28283;28283;28283;0;0;2303709005047.0
Ceará;Cigana;18357;18323;18323;0;34;2303709005010.0
Ceará;Conjunto Metropolitano;23516;23516;23516;0;0;2303709005012.0
Ceará;Grilo;19596;19596;19596;0;0;2303709005017.0
Ceará;Icaraí;22074;21977;21977;0;97;2303709005019.0
Ceará;Marechal Rondon;19803;19803;19803;0;0;2303709005049.0
Ceará;Nova Metrópole;22941;22941;22941;0;0;2303709005048.0
Ceará;Novo Pabussu;23824;23818;23818;0;6;2303709005030.0
Ceará;Parque Guadalajara;38018;38007;38007;0;11;2303709005053.0
Ceará;Parque Potira;20231;20231;20231;0;0;2303709005054.0
Ceará;Parque Soledade;21363;21363;21363;0;0;2303709005036.0
Ceará;Sitios Novos;30706;30706;30706;0;0;2303709005046.0
Ceará;Tabapuá;14955;14945;14945;0;10;2303709005041.0
Ceará;Tabuba;21774;21774;21774;0;0;2303709005043.0
Ceará;Crateús;72812;72784;72775;10;28;2304103.0
Ceará;Área 001;13877;13867;13858;10;10;2304103003001.0
Ceará;Área 002;15078;15078;15078;0;0;2304103003002.0
Ceará;Área 003;19571;19553;19553;0;18;2304103003003.0
Ceará;Área 004;24286;24286;24286;0;0;2304103003004.0
Ceará;Crato;121428;121381;121360;21;47;2304202.0
Ceará;Área 001;16587;16587;16587;0;0;2304202003001.0
Ceará;Área 002;15776;15763;15750;12;13;2304202003002.0
Ceará;Área 003;16906;16906;16906;0;0;2304202003003.0
Ceará;Área 004;16640;16640;16640;0;0;2304202003004.0
Ceará;Área 005;27753;27753;27753;0;0;2304202003005.0
Ceará;Área 006;27766;27732;27723;9;34;2304202003006.0
Ceará;Eusébio;46033;45936;45927;9;97;2304285.0
Ceará;Área 001;23009;23002;23002;0;7;2304285003001.0
Ceará;Área 002;23024;22933;22925;9;91;2304285003002.0
Ceará;Fortaleza;2452185;2449109;2448184;925;3076;2304400.0
Ceará;Aldeota;42361;42051;41988;63;310;2304400005002.0
Ceará;Ancuri;48041;48041;48041;0;0;2304400005050.0
Ceará;Antônio Bezerra;38782;38782;38782;0;0;2304400005040.0
Ceará;Autran Nunes;34355;34355;34355;0;0;2304400005041.0
Ceará;Barra do Ceará;72423;72423;72423;0;0;2304400005006.0
Ceará;Barroso;52734;52734;52701;33;0;2304400005051.0
Ceará;Bela Vista;30829;30829;30829;0;0;2304400005094.0
Ceará;Bom Jardim;37758;37741;37741;0;17;2304400005072.0
Ceará;Bonsucesso;41198;41198;41198;0;0;2304400005073.0
Ceará;Canindezinho;51688;51688;51688;0;0;2304400005074.0
Ceará;Carlito Pamplona;53123;53108;53108;0;15;2304400005009.0
Ceará;Centro;35433;35301;35281;20;132;2304400005010.0
Ceará;Coco;48798;48667;48544;123;131;2304400005011.0
Ceará;Conjunto Esperança;35621;35621;35621;0;0;2304400005076.0
Ceará;Conjunto Palmeiras;38041;38041;38041;0;0;2304400005118.0
Ceará;Cristo Redentor;44492;44492;44492;0;0;2304400005012.0
Ceará;Dias Macedo;35718;35718;35718;0;0;2304400005098.0
Ceará;Engenheiro Luciano Cavalcante;32636;32365;32322;43;271;2304400005058.0
Ceará;Fátima;32157;31993;31968;25;164;2304400005016.0
Ceará;Floresta;52080;52080;52059;21;0;2304400005017.0
Ceará;Genibau;59557;59557;59557;0;0;2304400005044.0
Ceará;Granja Lisboa;52808;52808;52808;0;0;2304400005078.0
Ceará;Granja Portugal;63324;63273;63273;0;51;2304400005079.0
Ceará;Henrique Jorge;45392;45370;45370;0;22;2304400005045.0
Ceará;Jacarecanga;39482;39482;39463;19;0;2304400005018.0
Ceará;Jangurussu;49037;49016;49016;0;21;2304400005061.0
Ceará;Jardim América;32645;32645;32645;0;0;2304400005019.0
Ceará;Jardim das Oliveiras;47827;47674;47662;13;153;2304400005062.0
Ceará;Joaquim Távora;39084;39012;38994;18;72;2304400005022.0
Ceará;Jóquei Club (São Cristóvão);30325;30308;30274;34;17;2304400005101.0
Ceará;José de Alencar;31264;31134;31108;26;130;2304400005049.0
Ceará;Lagoa Redonda;43922;43899;43899;0;23;2304400005063.0
Ceará;Lagoa Sapiranga (Coité);54368;54318;54307;11;50;2304400005064.0
Ceará;Manoel Sátiro;48107;48084;48084;0;23;2304400005081.0
Ceará;Meireles;37120;36488;36278;210;632;2304400005024.0
Ceará;Messejana (sede);41689;41650;41631;19;39;2304400005065.0
Ceará;Mondubim (Sede);76044;76021;76021;0;23;2304400005083.0
Ceará;Montese;38447;38404;38404;0;43;2304400005103.0
Ceará;Papicu;43770;43571;43399;171;199;2304400005027.0
Ceará;Parangaba;51592;51592;51592;0;0;2304400005105.0
Ceará;Parque Dois Irmãos;42976;42934;42934;0;42;2304400005084.0
Ceará;Parquelândia;32850;32738;32738;0;112;2304400005029.0
Ceará;Passaré;50940;50904;50873;31;36;2304400005088.0
Ceará;Pici (Parque Universitário);42494;42494;42494;0;0;2304400005106.0
Ceará;Planalto Ayrton Senna;39446;39446;39446;0;0;2304400005116.0
Ceará;Prefeito José Walter;33427;33427;33427;0;0;2304400005089.0
Ceará;Presidente Kennedy;44721;44699;44699;0;22;2304400005033.0
Ceará;Quintino Cunha;47277;47277;47277;0;0;2304400005048.0
Ceará;Rodolfo Teófilo;39097;38953;38953;0;144;2304400005034.0
Ceará;São João do Tauapé;28678;28622;28622;0;56;2304400005035.0
Ceará;Serrinha;51333;51317;51289;29;16;2304400005107.0
Ceará;Siqueira;33628;33628;33628;0;0;2304400005090.0
Ceará;Vicente Pinzon;67900;67900;67900;0;0;2304400005037.0
Ceará;Vila União;36810;36748;36732;17;62;2304400005109.0
Ceará;Vila Velha;76536;76486;76486;0;50;2304400005039.0
Ceará;Granja;52645;52645;52645;0;0;2304707.0
Ceará;Área 001;25689;25689;25689;0;0;2304707003001.0
Ceará;Área 002;26956;26956;26956;0;0;2304707003002.0
Ceará;Guaraciaba do Norte;37775;37764;37755;10;11;2305001.0
Ceará;Área 001;16349;16349;16349;0;0;2305001003001.0
Ceará;Área 002;21426;21415;21406;10;11;2305001003002.0
Ceará;Horizonte;55187;55187;55187;0;0;2305233.0
Ceará;Área 001;20492;20492;20492;0;0;2305233003001.0
Ceará;Área 002;34695;34695;34695;0;0;2305233003002.0
Ceará;Icó;65456;65456;65456;0;0;2305407.0
Ceará;Área 001;23004;23004;23004;0;0;2305407003001.0
Ceará;Área 002;42452;42452;42452;0;0;2305407003002.0
Ceará;Iguatu;96495;96485;96485;0;10;2305506.0
Ceará;Área 001;13267;13267;13267;0;0;2305506003001.0
Ceará;Área 002;13561;13561;13561;0;0;2305506003002.0
Ceará;Área 003;13658;13658;13658;0;0;2305506003003.0
Ceará;Área 004;13533;13533;13533;0;0;2305506003004.0
Ceará;Área 005;18887;18877;18877;0;10;2305506003005.0
Ceará;Área 006;23589;23589;23589;0;0;2305506003006.0
Ceará;Ipu;40296;40296;40296;0;0;2305803.0
Ceará;Área 001;19548;19548;19548;0;0;2305803003001.0
Ceará;Área 002;20748;20748;20748;0;0;2305803003002.0
Ceará;Ipueiras;37862;37862;37862;0;0;2305902.0
Ceará;Área 001;18077;18077;18077;0;0;2305902003001.0
Ceará;Área 002;19785;19785;19785;0;0;2305902003002.0
Ceará;Itaitinga;35817;35806;35806;0;11;2306256.0
Ceará;Área 001;14948;14948;14948;0;0;2306256003001.0
Ceará;Área 002;20869;20858;20858;0;11;2306256003002.0
Ceará;Itapagé;48350;48350;48350;0;0;2306306.0
Ceará;Área 001;21024;21024;21024;0;0;2306306003001.0
Ceará;Área 002;27326;27326;27326;0;0;2306306003002.0
Ceará;Itapipoca;116065;116052;116038;14;13;2306405.0
Ceará;Área 001;16015;16002;16002;0;13;2306405003001.0
Ceará;Área 002;18008;18008;18008;0;0;2306405003002.0
Ceará;Área 003;15657;15657;15657;0;0;2306405003003.0
Ceará;Área 004;27452;27452;27438;14;0;2306405003004.0
Ceará;Área 005;38933;38933;38933;0;0;2306405003005.0
Ceará;Itarema;37471;37471;37460;11;0;2306553.0
Ceará;Área 001;17571;17571;17571;0;0;2306553003001.0
Ceará;Área 002;19900;19900;19889;11;0;2306553003002.0
Ceará;Jaguaribe;34409;34409;34409;0;0;2306900.0
Ceará;Área 001;14596;14596;14596;0;0;2306900003001.0
Ceará;Área 002;19813;19813;19813;0;0;2306900003002.0
Ceará;Jaguaruana;32236;32236;32236;0;0;2307007.0
Ceará;Área 001;13305;13305;13305;0;0;2307007003001.0
Ceará;Área 002;18931;18931;18931;0;0;2307007003002.0
Ceará;Juazeiro do Norte;249939;249901;249869;33;38;2307304.0
Ceará;Centro-Socorro-Salgadinho-Horto;14501;14492;14492;0;9;2307304005001.0
Ceará;Franciscanos-Pio XII;23489;23489;23489;0;0;2307304005014.0
Ceará;Frei Damião-São José;24803;24793;24793;0;10;2307304005035.0
Ceará;Jardim Gonzaga-Lagoa Seca-Cidade Universitaria-Planalto-Jose Geraldo da Cruz;16529;16529;16529;0;0;2307304005029.0
Ceará;João Cabral;17859;17859;17859;0;0;2307304005018.0
Ceará;Limoeiro-Leandro Bezerra de Menezes;15382;15382;15382;0;0;2307304005015.0
Ceará;Piraja-Romeirão;21910;21910;21910;0;0;2307304005016.0
Ceará;Salesianos-Santo Antônio;19890;19890;19890;0;0;2307304005022.0
Ceará;São Miguel-Fatima-Juvêncio Santana;16390;16390;16357;33;0;2307304005003.0
Ceará;Timbauba-Aeroporto-Pedrinhas;22740;22740;22740;0;0;2307304005012.0
Ceará;Tiradentes-Novo Juazeiro-Campo Alegre;15979;15979;15979;0;0;2307304005032.0
Ceará;Triangulo-Antônio Vieira-Santa Teresa;23416;23397;23397;0;19;2307304005019.0
Ceará;Zona Rural – Betolândia-Brejo Seco-Carite – Três Marias;17051;17051;17051;0;0;2307304005000.0
Ceará;Lavras da Mangabeira;31090;31090;31090;0;0;2307502.0
Ceará;Área 001;14492;14492;14492;0;0;2307502003001.0
Ceará;Área 002;16598;16598;16598;0;0;2307502003002.0
Ceará;Limoeiro do Norte;56264;56264;56264;0;0;2307601.0
Ceará;Área 001;27184;27184;27184;0;0;2307601003001.0
Ceará;Área 002;29080;29080;29080;0;0;2307601003002.0
Ceará;Maracanaú;209057;209035;209035;0;22;2307650.0
Ceará;Alto da Mangueira;17734;17734;17734;0;0;2307650005014.0
Ceará;Conjunto Timbó;14537;14537;14537;0;0;2307650005006.0
Ceará;Distrito Industrial do Ceará;15911;15911;15911;0;0;2307650005005.0
Ceará;Jardim Bandeirante;23657;23657;23657;0;0;2307650005045.0
Ceará;Jereissati Setor A;19530;19530;19530;0;0;2307650005009.0
Ceará;Jereissati Setor D;19184;19173;19173;0;11;2307650005010.0
Ceará;Novo Maracanaú;19855;19855;19855;0;0;2307650005004.0
Ceará;Novo Oriente;16607;16607;16607;0;0;2307650005033.0
Ceará;Pajuçara;20125;20114;20114;0;11;2307650005038.0
Ceará;Parque Luzardo Viana;17266;17266;17266;0;0;2307650005020.0
Ceará;Siqueira;24651;24651;24651;0;0;2307650005029.0
Ceará;Maranguape;113561;113533;113510;24;28;2307700.0
Ceará;Área 001;17903;17903;17903;0;0;2307700003001.0
Ceará;Área 002;17177;17166;17166;0;11;2307700003002.0
Ceará;Área 003;18878;18878;18854;24;0;2307700003003.0
Ceará;Área 004;28247;28230;28230;0;17;2307700003004.0
Ceará;Área 005;31356;31356;31356;0;0;2307700003005.0
Ceará;Massapê;35191;35191;35191;0;0;2308005.0
Ceará;Área 001;17125;17125;17125;0;0;2308005003001.0
Ceará;Área 002;18066;18066;18066;0;0;2308005003002.0
Ceará;Mauriti;44240;44240;44240;0;0;2308104.0
Ceará;Área 001;16111;16111;16111;0;0;2308104003001.0
Ceará;Área 002;28129;28129;28129;0;0;2308104003002.0
Ceará;Missão Velha;34274;34266;34266;0;8;2308401.0
Ceará;Área 001;16147;16147;16147;0;0;2308401003001.0
Ceará;Área 002;18127;18119;18119;0;8;2308401003002.0
Ceará;Mombaça;42690;42690;42690;0;0;2308500.0
Ceará;Área 001;14847;14847;14847;0;0;2308500003001.0
Ceará;Área 002;27843;27843;27843;0;0;2308500003002.0
Ceará;Morada Nova;62065;62065;62065;0;0;2308708.0
Ceará;Área 001;24755;24755;24755;0;0;2308708003001.0
Ceará;Área 002;37310;37310;37310;0;0;2308708003002.0
Ceará;Nova Russas;30965;30965;30965;0;0;2309300.0
Ceará;Área 001;13059;13059;13059;0;0;2309300003001.0
Ceará;Área 002;17906;17906;17906;0;0;2309300003002.0
Ceará;Pacajus;61838;61838;61838;0;0;2309607.0
Ceará;Área 001;27872;27872;27872;0;0;2309607003001.0
Ceará;Área 002;33966;33966;33966;0;0;2309607003002.0
Ceará;Pacatuba;72299;72299;72278;21;0;2309706.0
Ceará;Área 001;16574;16574;16574;0;0;2309706003001.0
Ceará;Área 002;23390;23390;23384;6;0;2309706003002.0
Ceará;Área 003;32335;32335;32320;15;0;2309706003003.0
Ceará;Paracuru;31636;31545;31545;0;91;2310209.0
Ceará;Área 001;15093;15032;15032;0;61;2310209003001.0
Ceará;Área 002;16543;16513;16513;0;30;2310209003002.0
Ceará;Parambu;31309;31309;31309;0;0;2310308.0
Ceará;Área 001;17230;17230;17230;0;0;2310308003001.0
Ceará;Área 002;14079;14079;14079;0;0;2310308003002.0
Ceará;Pedra Branca;41890;41890;41890;0;0;2310506.0
Ceará;Área 001;13444;13444;13444;0;0;2310506003001.0
Ceará;Área 002;28446;28446;28446;0;0;2310506003002.0
Ceará;Pentecoste;35400;35400;35400;0;0;2310704.0
Ceará;Área 001;14970;14970;14970;0;0;2310704003001.0
Ceará;Área 002;20430;20430;20430;0;0;2310704003002.0
Ceará;Quixadá;80604;80555;80555;0;49;2311306.0
Ceará;Área 001;14841;14825;14825;0;16;2311306003001.0
Ceará;Área 002;32737;32715;32715;0;22;2311306003002.0
Ceará;Área 003;33026;33015;33015;0;11;2311306003003.0
Ceará;Quixeramobim;71887;71887;71887;0;0;2311405.0
Ceará;Área 001;13505;13505;13505;0;0;2311405003001.0
Ceará;Área 002;28540;28540;28540;0;0;2311405003002.0
Ceará;Área 003;29842;29842;29842;0;0;2311405003003.0
Ceará;Russas;69833;69833;69833;0;0;2311801.0
Ceará;Área 001;14497;14497;14497;0;0;2311801003001.0
Ceará;Área 002;26859;26859;26859;0;0;2311801003002.0
Ceará;Área 003;28477;28477;28477;0;0;2311801003003.0
Ceará;Santa Quitéria;42763;42763;42763;0;0;2312205.0
Ceará;Área 001;19371;19371;19371;0;0;2312205003001.0
Ceará;Área 002;23392;23392;23392;0;0;2312205003002.0
Ceará;São Benedito;44178;44155;44155;0;23;2312304.0
Ceará;Área 001;21128;21128;21128;0;0;2312304003001.0
Ceará;Área 002;23050;23027;23027;0;23;2312304003002.0
Ceará;São Gonçalo do Amarante;43890;43843;43778;66;47;2312403.0
Ceará;Área 001;14632;14632;14632;0;0;2312403003001.0
Ceará;Área 002;29258;29211;29146;66;47;2312403003002.0
Ceará;Sobral;188233;188177;188169;9;56;2312908.0
Ceará;Área 001;18446;18441;18441;0;5;2312908003001.0
Ceará;Área 002;26370;26370;26370;0;0;2312908003002.0
Ceará;Área 003;17665;17665;17665;0;0;2312908003003.0
Ceará;Área 004;16812;16783;16783;0;29;2312908003004.0
Ceará;Área 005;17294;17281;17281;0;13;2312908003005.0
Ceará;Área 006;16965;16965;16965;0;0;2312908003006.0
Ceará;Área 007;18143;18143;18143;0;0;2312908003007.0
Ceará;Área 008;23249;23249;23249;0;0;2312908003008.0
Ceará;Área 009;33289;33280;33271;9;9;2312908003009.0
Ceará;Tabuleiro do Norte;29204;29204;29204;0;0;2313104.0
Ceará;Área 001;12966;12966;12966;0;0;2313104003001.0
Ceará;Área 002;16238;16238;16238;0;0;2313104003002.0
Ceará;Tauá;55716;55698;55698;0;18;2313302.0
Ceará;Área 001;21121;21121;21121;0;0;2313302003001.0
Ceará;Área 002;34595;34577;34577;0;18;2313302003002.0
Ceará;Tianguá;68892;68881;68881;0;11;2313401.0
Ceará;Área 001;15588;15577;15577;0;11;2313401003001.0
Ceará;Área 002;27675;27675;27675;0;0;2313401003002.0
Ceará;Área 003;25629;25629;25629;0;0;2313401003003.0
Ceará;Trairi;51422;51374;51365;10;48;2313500.0
Ceará;Área 001;25698;25650;25650;0;48;2313500003001.0
Ceará;Área 002;25724;25724;25714;10;0;2313500003002.0
Ceará;Várzea Alegre;38434;38434;38434;0;0;2314003.0
Ceará;Área 001;13241;13241;13241;0;0;2314003003001.0
Ceará;Área 002;25193;25193;25193;0;0;2314003003002.0
Ceará;Viçosa do Ceará;54955;54955;54955;0;0;2314102.0
Ceará;Área 001;26351;26351;26351;0;0;2314102003001.0
Ceará;Área 002;28604;28604;28604;0;0;2314102003002.0
Rio Grande do Norte;Açu;53227;53216;53205;11;11;2400208.0
Rio Grande do Norte;Área 001;24390;24390;24390;0;0;2400208003001.0
Rio Grande do Norte;Área 002;28837;28826;28815;11;11;2400208003002.0
Rio Grande do Norte;Apodi;34763;34763;34763;0;0;2401008.0
Rio Grande do Norte;Área 001;15787;15787;15787;0;0;2401008003001.0
Rio Grande do Norte;Área 002;18976;18976;18976;0;0;2401008003002.0
Rio Grande do Norte;Caicó;62709;62709;62709;0;0;2402006.0
Rio Grande do Norte;Área 001;14293;14293;14293;0;0;2402006003001.0
Rio Grande do Norte;Área 002;22909;22909;22909;0;0;2402006003002.0
Rio Grande do Norte;Área 003;25507;25507;25507;0;0;2402006003003.0
Rio Grande do Norte;Ceará-Mirim;68141;68130;68130;0;11;2402600.0
Rio Grande do Norte;Área 001;16825;16825;16825;0;0;2402600003001.0
Rio Grande do Norte;Área 002;17618;17618;17618;0;0;2402600003002.0
Rio Grande do Norte;Área 003;33698;33687;33687;0;11;2402600003003.0
Rio Grande do Norte;Currais Novos;42652;42652;42652;0;0;2403103.0
Rio Grande do Norte;Área 001;20556;20556;20556;0;0;2403103003001.0
Rio Grande do Norte;Área 002;22096;22096;22096;0;0;2403103003002.0
Rio Grande do Norte;Macaíba;69467;69467;69467;0;0;2407104.0
Rio Grande do Norte;Área 001;25621;25621;25621;0;0;2407104003001.0
Rio Grande do Norte;Área 002;43846;43846;43846;0;0;2407104003002.0
Rio Grande do Norte;Macau;28954;28954;28954;0;0;2407203.0
Rio Grande do Norte;Área 001;13929;13929;13929;0;0;2407203003001.0
Rio Grande do Norte;Área 002;15025;15025;15025;0;0;2407203003002.0
Rio Grande do Norte;Mossoró;259815;259719;259669;50;96;2408003.0
Rio Grande do Norte;Área 001;15658;15649;15649;0;9;2408003005001.0
Rio Grande do Norte;Área 002;16481;16481;16481;0;0;2408003005002.0
Rio Grande do Norte;Área 003;19192;19192;19192;0;0;2408003005003.0
Rio Grande do Norte;Área 004;18336;18327;18327;0;9;2408003005004.0
Rio Grande do Norte;Área 005;17692;17692;17692;0;0;2408003005005.0
Rio Grande do Norte;Área 006;20372;20372;20372;0;0;2408003005006.0
Rio Grande do Norte;Área 007;16837;16837;16827;10;0;2408003005007.0
Rio Grande do Norte;Área 008;21187;21187;21187;0;0;2408003005008.0
Rio Grande do Norte;Área 009;28675;28608;28567;41;67;2408003005009.0
Rio Grande do Norte;Área 010;24741;24731;24731;0;10;2408003005010.0
Rio Grande do Norte;Área 011;19107;19107;19107;0;0;2408003005011.0
Rio Grande do Norte;Área 012;18963;18963;18963;0;0;2408003005012.0
Rio Grande do Norte;Área 013;22574;22574;22574;0;0;2408003005013.0
Rio Grande do Norte;Natal;803739;802686;802227;458;1053;2408102.0
Rio Grande do Norte;Área 001;28845;28808;28734;74;37;2408102004001.0
Rio Grande do Norte;Área 002;28899;28899;28899;0;0;2408102004002.0
Rio Grande do Norte;Área 003;32011;32011;32011;0;0;2408102004003.0
Rio Grande do Norte;Área 004;80404;80308;80229;80;96;2408102004004.0
Rio Grande do Norte;Área 005;30302;30302;30302;0;0;2408102004005.0
Rio Grande do Norte;Área 006;27303;26964;26851;113;339;2408102004006.0
Rio Grande do Norte;Área 007;30009;29981;29956;24;28;2408102004007.0
Rio Grande do Norte;Área 008;31883;31883;31883;0;0;2408102004008.0
Rio Grande do Norte;Área 009;29294;29294;29294;0;0;2408102004009.0
Rio Grande do Norte;Área 010;29311;29311;29311;0;0;2408102004010.0
Rio Grande do Norte;Área 011;30385;30166;30054;113;219;2408102004011.0
Rio Grande do Norte;Área 012;30405;30365;30351;14;40;2408102004012.0
Rio Grande do Norte;Área 013;29003;28959;28944;15;44;2408102004013.0
Rio Grande do Norte;Área 014;32069;32069;32069;0;0;2408102004014.0
Rio Grande do Norte;Área 015;29540;29540;29540;0;0;2408102004015.0
Rio Grande do Norte;Área 016;31854;31838;31838;0;16;2408102004016.0
Rio Grande do Norte;Área 017;31889;31777;31777;0;112;2408102004017.0
Rio Grande do Norte;Área 018;30025;30025;30000;25;0;2408102004018.0
Rio Grande do Norte;Área 019;28664;28664;28664;0;0;2408102004019.0
Rio Grande do Norte;Área 020;34087;34070;34070;0;17;2408102004020.0
Rio Grande do Norte;Área 021;29370;29370;29370;0;0;2408102004021.0
Rio Grande do Norte;Área 022;43714;43714;43714;0;0;2408102004022.0
Rio Grande do Norte;Área 023;74473;74368;74368;0;105;2408102004023.0
Rio Grande do Norte;Nova Cruz;35490;35490;35490;0;0;2408300.0
Rio Grande do Norte;Área 001;20600;20600;20600;0;0;2408300003001.0
Rio Grande do Norte;Área 002;14890;14890;14890;0;0;2408300003002.0
Rio Grande do Norte;Parnamirim;202456;202099;201886;212;357;2403251.0
Rio Grande do Norte;Bela Parnamirim-Nova Esperança;15940;15940;15940;0;0;2403251005010.0
Rio Grande do Norte;Cohabinal-Santa Tereza-Vale do Sol;14757;14757;14748;9;0;2403251005002.0
Rio Grande do Norte;Emaús;22429;22386;22375;11;43;2403251005003.0
Rio Grande do Norte;Liberdade-Jardim Planalto-Centro-Boa Esperança;23910;23910;23895;15;0;2403251005001.0
Rio Grande do Norte;Monte Castelo-Parque de Exposições-Vida Nova;24683;24665;24645;20;18;2403251005006.0
Rio Grande do Norte;Nova Parnamirim 1;16210;16156;16156;0;54;2403251005007.0
Rio Grande do Norte;Nova Parnamirim 2;14753;14729;14729;0;24;2403251005008.0
Rio Grande do Norte;Nova Parnamirim 3;17960;17838;17728;110;122;2403251005009.0
Rio Grande do Norte;Passagem de Areia;16744;16744;16720;24;0;2403251005005.0
Rio Grande do Norte;Pium-Cotovelo-Pirangi-Base Aérea-B.Do Inferno-Área de Expansão-Cajupiranga;15027;14931;14907;24;96;2403251005011.0
Rio Grande do Norte;Rosa dos Ventos-Santos Reis;20043;20043;20043;0;0;2403251005004.0
Rio Grande do Norte;Santa Cruz;35797;35797;35797;0;0;2411205.0
Rio Grande do Norte;Área 001;15516;15516;15516;0;0;2411205003001.0
Rio Grande do Norte;Área 002;20281;20281;20281;0;0;2411205003002.0
Rio Grande do Norte;São Gonçalo do Amarante;87668;87644;87632;12;24;2412005.0
Rio Grande do Norte;Área 001;15610;15610;15610;0;0;2412005003001.0
Rio Grande do Norte;Área 002;16247;16247;16247;0;0;2412005003002.0
Rio Grande do Norte;Área 003;24427;24403;24403;0;24;2412005003003.0
Rio Grande do Norte;Área 004;31384;31384;31372;12;0;2412005003004.0
Rio Grande do Norte;São José de Mipibu;39776;39776;39776;0;0;2412203.0
Rio Grande do Norte;Área 001;21927;21927;21927;0;0;2412203003001.0
Rio Grande do Norte;Área 002;17849;17849;17849;0;0;2412203003002.0
Paraíba;Bayeux;99716;99672;99639;33;44;2501807.0
Paraíba;Área 001;15745;15745;15745;0;0;2501807003001.0
Paraíba;Área 002;18629;18585;18572;12;44;2501807003002.0
Paraíba;Área 003;26730;26730;26730;0;0;2501807003003.0
Paraíba;Área 004;38612;38612;38591;21;0;2501807003004.0
Paraíba;Cabedelo;57944;57913;57853;60;31;2503209.0
Paraíba;Área 001;14510;14500;14500;0;10;2503209003001.0
Paraíba;Área 002;19680;19659;19610;49;21;2503209003002.0
Paraíba;Área 003;23754;23754;23743;11;0;2503209003003.0
Paraíba;Cajazeiras;58446;58446;58446;0;0;2503704.0
Paraíba;Área 001;13614;13614;13614;0;0;2503704003001.0
Paraíba;Área 002;22151;22151;22151;0;0;2503704003002.0
Paraíba;Área 003;22681;22681;22681;0;0;2503704003003.0
Paraíba;Campina Grande;385213;385132;385075;57;81;2504009.0
Paraíba;Área 001;17629;17582;17582;0;47;2504009005001.0
Paraíba;Área 002;18765;18765;18765;0;0;2504009005002.0
Paraíba;Área 003;16320;16320;16320;0;0;2504009005003.0
Paraíba;Área 004;16940;16940;16940;0;0;2504009005004.0
Paraíba;Área 005;21084;21084;21084;0;0;2504009005005.0
Paraíba;Área 006;16513;16513;16513;0;0;2504009005006.0
Paraíba;Área 007;17804;17804;17804;0;0;2504009005007.0
Paraíba;Área 008;15717;15683;15662;22;34;2504009005008.0
Paraíba;Área 009;16747;16747;16747;0;0;2504009005009.0
Paraíba;Área 010;15731;15731;15731;0;0;2504009005010.0
Paraíba;Área 011;15836;15836;15836;0;0;2504009005011.0
Paraíba;Área 012;16207;16207;16207;0;0;2504009005012.0
Paraíba;Área 013;16605;16605;16605;0;0;2504009005013.0
Paraíba;Área 014;14894;14894;14858;36;0;2504009005014.0
Paraíba;Área 015;16808;16808;16808;0;0;2504009005015.0
Paraíba;Área 016;17587;17587;17587;0;0;2504009005016.0
Paraíba;Área 017;32472;32472;32472;0;0;2504009005017.0
Paraíba;Área 018;25524;25524;25524;0;0;2504009005018.0
Paraíba;Área 019;19640;19640;19640;0;0;2504009005019.0
Paraíba;Área 020;19105;19105;19105;0;0;2504009005020.0
Paraíba;Área 021;17285;17285;17285;0;0;2504009005021.0
Paraíba;Catolé do Rocha;28759;28759;28759;0;0;2504306.0
Paraíba;Área 001;14385;14385;14385;0;0;2504306003001.0
Paraíba;Área 002;14374;14374;14374;0;0;2504306003002.0
Paraíba;Esperança;31095;31095;31095;0;0;2506004.0
Paraíba;Área 001;15055;15055;15055;0;0;2506004003001.0
Paraíba;Área 002;16040;16040;16040;0;0;2506004003002.0
Paraíba;Guarabira;55326;55326;55326;0;0;2506301.0
Paraíba;Área 001;14752;14752;14752;0;0;2506301003001.0
Paraíba;Área 002;20550;20550;20550;0;0;2506301003002.0
Paraíba;Área 003;20024;20024;20024;0;0;2506301003003.0
Paraíba;João Pessoa;723515;722363;722151;212;1152;2507507.0
Paraíba;Área 001;76904;76502;76400;102;402;2507507005001.0
Paraíba;Área 002;28684;28474;28474;0;210;2507507005002.0
Paraíba;Área 003;84329;84268;84268;0;61;2507507005003.0
Paraíba;Área 004;73876;73843;73843;0;33;2507507005004.0
Paraíba;Área 005;102063;101970;101970;0;93;2507507005005.0
Paraíba;Área 006;32277;32277;32277;0;0;2507507005006.0
Paraíba;Área 007;70042;70004;70004;0;38;2507507005007.0
Paraíba;Área 008;54674;54674;54674;0;0;2507507005008.0
Paraíba;Área 009;35646;35646;35646;0;0;2507507005009.0
Paraíba;Área 010;77484;77419;77419;0;65;2507507005010.0
Paraíba;Área 011;36894;36791;36701;90;103;2507507005011.0
Paraíba;Área 012;50642;50496;50476;19;146;2507507005012.0
Paraíba;Mamanguape;42303;42303;42291;12;0;2508901.0
Paraíba;Área 001;26217;26217;26205;12;0;2508901003001.0
Paraíba;Área 002;16086;16086;16086;0;0;2508901003002.0
Paraíba;Monteiro;30852;30852;30852;0;0;2509701.0
Paraíba;Área 001;14760;14760;14760;0;0;2509701003001.0
Paraíba;Área 002;16092;16092;16092;0;0;2509701003002.0
Paraíba;Patos;100674;100674;100674;0;0;2510808.0
Paraíba;Área 001;15452;15452;15452;0;0;2510808003001.0
Paraíba;Área 002;20104;20104;20104;0;0;2510808003002.0
Paraíba;Área 003;14764;14764;14764;0;0;2510808003003.0
Paraíba;Área 004;26338;26338;26338;0;0;2510808003004.0
Paraíba;Área 005;24016;24016;24016;0;0;2510808003005.0
Paraíba;Pombal;32110;32110;32110;0;0;2512101.0
Paraíba;Área 001;15964;15964;15964;0;0;2512101003001.0
Paraíba;Área 002;16146;16146;16146;0;0;2512101003002.0
Paraíba;Queimadas;41049;41049;41049;0;0;2512507.0
Paraíba;Área 001;13886;13886;13886;0;0;2512507003001.0
Paraíba;Área 002;27163;27163;27163;0;0;2512507003002.0
Paraíba;Santa Rita;120310;120299;120289;9;11;2513703.0
Paraíba;Área 001;21603;21603;21594;9;0;2513703003001.0
Paraíba;Área 002;16905;16905;16905;0;0;2513703003002.0
Paraíba;Área 003;17502;17502;17502;0;0;2513703003003.0
Paraíba;Área 004;15098;15098;15098;0;0;2513703003004.0
Paraíba;Área 005;23666;23655;23655;0;11;2513703003005.0
Paraíba;Área 006;25536;25536;25536;0;0;2513703003006.0
Paraíba;Sapé;50143;50143;50143;0;0;2515302.0
Paraíba;Área 001;24504;24504;24504;0;0;2515302003001.0
Paraíba;Área 002;25639;25639;25639;0;0;2515302003002.0
Paraíba;Sousa;65803;65803;65803;0;0;2516201.0
Paraíba;Área 001;13680;13680;13680;0;0;2516201003001.0
Paraíba;Área 002;25203;25203;25203;0;0;2516201003002.0
Paraíba;Área 003;26920;26920;26920;0;0;2516201003003.0
Pernambuco;Abreu e Lima;94429;94407;94393;14;22;2600054.0
Pernambuco;Área 001;13985;13985;13985;0;0;2600054003001.0
Pernambuco;Área 002;14836;14836;14836;0;0;2600054003002.0
Pernambuco;Área 003;16503;16503;16503;0;0;2600054003003.0
Pernambuco;Área 004;24119;24107;24107;0;12;2600054003004.0
Pernambuco;Área 005;24986;24976;24961;14;10;2600054003005.0
Pernambuco;Afogados da Ingazeira;35088;35088;35088;0;0;2600104.0
Pernambuco;Área 001;14366;14366;14366;0;0;2600104003001.0
Pernambuco;Área 002;20722;20722;20722;0;0;2600104003002.0
Pernambuco;Águas Belas;40235;40235;40235;0;0;2600500.0
Pernambuco;Área 001;24691;24691;24691;0;0;2600500003001.0
Pernambuco;Área 002;15544;15544;15544;0;0;2600500003002.0
Pernambuco;Aliança;37415;37415;37415;0;0;2600708.0
Pernambuco;Área 001;16264;16264;16264;0;0;2600708003001.0
Pernambuco;Área 002;21151;21151;21151;0;0;2600708003002.0
Pernambuco;Araripina;77302;77302;77302;0;0;2601102.0
Pernambuco;Área 001;15298;15298;15298;0;0;2601102003001.0
Pernambuco;Área 002;30455;30455;30455;0;0;2601102003002.0
Pernambuco;Área 003;31549;31549;31549;0;0;2601102003003.0
Pernambuco;Arcoverde;68793;68793;68793;0;0;2601201.0
Pernambuco;Área 001;13743;13743;13743;0;0;2601201003001.0
Pernambuco;Área 002;25965;25965;25965;0;0;2601201003002.0
Pernambuco;Área 003;29085;29085;29085;0;0;2601201003003.0
Pernambuco;Barreiros;40732;40732;40732;0;0;2601409.0
Pernambuco;Área 001;16074;16074;16074;0;0;2601409003001.0
Pernambuco;Área 002;24658;24658;24658;0;0;2601409003002.0
Pernambuco;Belo Jardim;72432;72432;72432;0;0;2601706.0
Pernambuco;Área 001;12940;12940;12940;0;0;2601706003001.0
Pernambuco;Área 002;28196;28196;28196;0;0;2601706003002.0
Pernambuco;Área 003;31296;31296;31296;0;0;2601706003003.0
Pernambuco;Bezerros;58668;58657;58657;0;11;2601904.0
Pernambuco;Área 001;12271;12260;12260;0;11;2601904003001.0
Pernambuco;Área 002;19440;19440;19440;0;0;2601904003002.0
Pernambuco;Área 003;26957;26957;26957;0;0;2601904003003.0
Pernambuco;Bodocó;35158;35151;35151;0;7;2602001.0
Pernambuco;Área 001;15997;15990;15990;0;7;2602001003001.0
Pernambuco;Área 002;19161;19161;19161;0;0;2602001003002.0
Pernambuco;Bom Conselho;45503;45503;45503;0;0;2602100.0
Pernambuco;Área 001;19948;19948;19948;0;0;2602100003001.0
Pernambuco;Área 002;25555;25555;25555;0;0;2602100003002.0
Pernambuco;Bom Jardim;37826;37826;37826;0;0;2602209.0
Pernambuco;Área 001;14323;14323;14323;0;0;2602209003001.0
Pernambuco;Área 002;23503;23503;23503;0;0;2602209003002.0
Pernambuco;Bonito;37566;37566;37556;10;0;2602308.0
Pernambuco;Área 001;14667;14667;14657;10;0;2602308003001.0
Pernambuco;Área 002;22899;22899;22899;0;0;2602308003002.0
Pernambuco;Brejo da Madre de Deus;45180;45180;45180;0;0;2602605.0
Pernambuco;Área 001;18276;18276;18276;0;0;2602605003001.0
Pernambuco;Área 002;26904;26904;26904;0;0;2602605003002.0
Pernambuco;Buíque;52105;52105;52105;0;0;2602803.0
Pernambuco;Área 001;18544;18544;18544;0;0;2602803003001.0
Pernambuco;Área 002;33561;33561;33561;0;0;2602803003002.0
Pernambuco;Cabo de Santo Agostinho;185025;184895;184862;33;130;2602902.0
Pernambuco;Área 001;14667;14667;14667;0;0;2602902003001.0
Pernambuco;Área 002;14332;14243;14219;24;89;2602902003002.0
Pernambuco;Área 003;15875;15875;15875;0;0;2602902003003.0
Pernambuco;Área 004;47363;47363;47363;0;0;2602902003004.0
Pernambuco;Área 005;16950;16937;16928;9;13;2602902003005.0
Pernambuco;Área 006;22803;22803;22803;0;0;2602902003006.0
Pernambuco;Área 007;24650;24650;24650;0;0;2602902003007.0
Pernambuco;Área 008;28385;28356;28356;0;29;2602902003008.0
Pernambuco;Camaragibe;144466;144374;144345;29;92;2603454.0
Pernambuco;Área 001;15047;14997;14997;0;50;2603454003001.0
Pernambuco;Área 002;19093;19060;19040;20;33;2603454003002.0
Pernambuco;Área 003;15001;15001;15001;0;0;2603454003003.0
Pernambuco;Área 004;15205;15205;15205;0;0;2603454003004.0
Pernambuco;Área 005;14714;14714;14714;0;0;2603454003005.0
Pernambuco;Área 006;26129;26121;26121;0;8;2603454003006.0
Pernambuco;Área 007;39277;39277;39268;9;0;2603454003007.0
Pernambuco;Carpina;74858;74858;74848;10;0;2604007.0
Pernambuco;Área 001;16632;16632;16632;0;0;2604007003001.0
Pernambuco;Área 002;22636;22636;22636;0;0;2604007003002.0
Pernambuco;Área 003;35590;35590;35580;10;0;2604007003003.0
Pernambuco;Caruaru;314912;314841;314815;26;71;2604106.0
Pernambuco;Área 001;13970;13964;13964;0;6;2604106003001.0
Pernambuco;Área 002;12516;12516;12507;9;0;2604106003002.0
Pernambuco;Área 003;110084;110073;110073;0;11;2604106003003.0
Pernambuco;Área 004;15529;15529;15529;0;0;2604106003004.0
Pernambuco;Área 005;14264;14264;14264;0;0;2604106003005.0
Pernambuco;Área 006;15635;15635;15635;0;0;2604106003006.0
Pernambuco;Área 007;15287;15233;15233;0;54;2604106003007.0
Pernambuco;Área 008;17860;17860;17848;12;0;2604106003008.0
Pernambuco;Área 009;20674;20674;20674;0;0;2604106003009.0
Pernambuco;Área 010;15728;15728;15722;6;0;2604106003010.0
Pernambuco;Área 011;25922;25922;25922;0;0;2604106003011.0
Pernambuco;Área 012;37443;37443;37443;0;0;2604106003012.0
Pernambuco;Catende;37820;37820;37820;0;0;2604205.0
Pernambuco;Área 001;15170;15170;15170;0;0;2604205003001.0
Pernambuco;Área 002;22650;22650;22650;0;0;2604205003002.0
Pernambuco;Cumaru;17183;17183;17183;0;0;2604908.0
Pernambuco;Distrito 05 de Cumaru;8759;8759;8759;0;0;2604908002001.0
Pernambuco;Distrito 10 de Cumaru;8424;8424;8424;0;0;2604908002002.0
Pernambuco;Custódia;33855;33855;33855;0;0;2605103.0
Pernambuco;Área 001;14643;14643;14643;0;0;2605103003001.0
Pernambuco;Área 002;19212;19212;19212;0;0;2605103003002.0
Pernambuco;Escada;63517;63517;63517;0;0;2605202.0
Pernambuco;Área 001;23470;23470;23470;0;0;2605202003001.0
Pernambuco;Área 002;40047;40047;40047;0;0;2605202003002.0
Pernambuco;Exu;31636;31636;31636;0;0;2605301.0
Pernambuco;Área 001;15678;15678;15678;0;0;2605301003001.0
Pernambuco;Área 002;15958;15958;15958;0;0;2605301003002.0
Pernambuco;Frei Miguelinho;14293;14293;14293;0;0;2605806.0
Pernambuco;Distrito 05 de Frei Miguelinho;7070;7070;7070;0;0;2605806002001.0
Pernambuco;Distrito 10 de Frei Miguelinho;7223;7223;7223;0;0;2605806002002.0
Pernambuco;Garanhuns;129408;129396;129396;0;12;2606002.0
Pernambuco;Área 001;16159;16159;16159;0;0;2606002003001.0
Pernambuco;Área 002;12925;12925;12925;0;0;2606002003002.0
Pernambuco;Área 003;14251;14251;14251;0;0;2606002003003.0
Pernambuco;Área 004;16084;16084;16084;0;0;2606002003004.0
Pernambuco;Área 005;14773;14773;14773;0;0;2606002003005.0
Pernambuco;Área 006;27353;27353;27353;0;0;2606002003006.0
Pernambuco;Área 007;27863;27851;27851;0;12;2606002003007.0
Pernambuco;Goiana;75644;75621;75621;0;23;2606200.0
Pernambuco;Área 001;16160;16148;16148;0;12;2606200003001.0
Pernambuco;Área 002;28104;28093;28093;0;11;2606200003002.0
Pernambuco;Área 003;31380;31380;31380;0;0;2606200003003.0
Pernambuco;Gravatá;76458;76445;76445;0;13;2606408.0
Pernambuco;Área 001;13187;13187;13187;0;0;2606408003001.0
Pernambuco;Área 002;20623;20623;20623;0;0;2606408003002.0
Pernambuco;Área 003;16412;16412;16412;0;0;2606408003003.0
Pernambuco;Área 004;26236;26223;26223;0;13;2606408003004.0
Pernambuco;Igarassu;102021;101999;101999;0;22;2606804.0
Pernambuco;Área 001;15846;15846;15846;0;0;2606804003001.0
Pernambuco;Área 002;16474;16461;16461;0;13;2606804003002.0
Pernambuco;Área 003;17556;17556;17556;0;0;2606804003003.0
Pernambuco;Área 004;26120;26120;26120;0;0;2606804003004.0
Pernambuco;Área 005;26025;26016;26016;0;9;2606804003005.0
Pernambuco;Ipojuca;80637;80610;80564;46;27;2607208.0
Pernambuco;Área 001;15972;15972;15972;0;0;2607208003001.0
Pernambuco;Área 002;25874;25874;25874;0;0;2607208003002.0
Pernambuco;Área 003;38791;38764;38718;46;27;2607208003003.0
Pernambuco;Itambé;35398;35398;35398;0;0;2607653.0
Pernambuco;Área 001;15905;15905;15905;0;0;2607653003001.0
Pernambuco;Área 002;19493;19493;19493;0;0;2607653003002.0
Pernambuco;Jaboatão dos Guararapes;644620;644145;643885;260;475;2607901.0
Pernambuco;Barra de Jangada;34330;34330;34308;22;0;2607901005001.0
Pernambuco;Cajueiro Seco;54016;53999;53999;0;17;2607901005002.0
Pernambuco;Candeias 01;31191;30982;30853;129;209;2607901005003.0
Pernambuco;Candeias 02;33874;33852;33852;0;22;2607901005004.0
Pernambuco;Cavaleiro;36921;36921;36921;0;0;2607901005005.0
Pernambuco;Curado;49863;49836;49836;0;27;2607901005006.0
Pernambuco;Dois Carneiros-Zumbi do Pacheco;46517;46517;46517;0;0;2607901005007.0
Pernambuco;Guararapes;38985;38985;38985;0;0;2607901005008.0
Pernambuco;Jaboatão Centro 01;43734;43734;43734;0;0;2607901005009.0
Pernambuco;Jaboatão Centro 02;40597;40597;40597;0;0;2607901005010.0
Pernambuco;Jardim Jordão;27010;27010;27010;0;0;2607901005011.0
Pernambuco;Muribeca-Marcos Freire;48030;48030;48030;0;0;2607901005012.0
Pernambuco;Piedade 01;30686;30566;30502;64;120;2607901005013.0
Pernambuco;Piedade 02;34809;34754;34754;0;55;2607901005014.0
Pernambuco;Prazeres;37678;37653;37633;20;25;2607901005015.0
Pernambuco;Sucupira;27926;27926;27926;0;0;2607901005016.0
Pernambuco;Vila Rica;28453;28453;28427;26;0;2607901005017.0
Pernambuco;João Alfredo;30743;30743;30743;0;0;2608107.0
Pernambuco;Área 001;15939;15939;15939;0;0;2608107003001.0
Pernambuco;Área 002;14804;14804;14804;0;0;2608107003002.0
Pernambuco;Lajedo;36628;36628;36628;0;0;2608800.0
Pernambuco;Área 001;16904;16904;16904;0;0;2608800003001.0
Pernambuco;Área 002;19724;19724;19724;0;0;2608800003002.0
Pernambuco;Limoeiro;55439;55439;55439;0;0;2608909.0
Pernambuco;Área 001;27488;27488;27488;0;0;2608909003001.0
Pernambuco;Área 002;27951;27951;27951;0;0;2608909003002.0
Pernambuco;Moreno;56696;56696;56696;0;0;2609402.0
Pernambuco;Área 001;24959;24959;24959;0;0;2609402003001.0
Pernambuco;Área 002;31737;31737;31737;0;0;2609402003002.0
Pernambuco;Nazaré da Mata;30796;30790;30790;0;6;2609501.0
Pernambuco;Área 001;15262;15256;15256;0;6;2609501003001.0
Pernambuco;Área 002;15534;15534;15534;0;0;2609501003002.0
Pernambuco;Olinda;377779;377430;377355;75;349;2609600.0
Pernambuco;Área 001;33086;33086;33086;0;0;2609600005001.0
Pernambuco;Área 002;28920;28920;28920;0;0;2609600005002.0
Pernambuco;Área 003;24166;24166;24166;0;0;2609600005003.0
Pernambuco;Área 004;21588;21570;21570;0;18;2609600005004.0
Pernambuco;Área 005;14545;14536;14536;0;9;2609600005005.0
Pernambuco;Área 006;14322;14322;14322;0;0;2609600005006.0
Pernambuco;Área 007;22170;22170;22170;0;0;2609600005007.0
Pernambuco;Área 008;30644;30586;30577;9;58;2609600005008.0
Pernambuco;Área 009;27867;27867;27867;0;0;2609600005009.0
Pernambuco;Área 010;24339;24218;24200;18;121;2609600005010.0
Pernambuco;Área 011;39214;39173;39163;10;41;2609600005011.0
Pernambuco;Área 012;17996;17932;17922;10;64;2609600005012.0
Pernambuco;Área 013;14747;14747;14747;0;0;2609600005013.0
Pernambuco;Área 014;22540;22512;22505;7;28;2609600005014.0
Pernambuco;Área 015;41635;41625;41604;21;10;2609600005015.0
Pernambuco;Ouricuri;64358;64358;64358;0;0;2609907.0
Pernambuco;Área 001;28319;28319;28319;0;0;2609907003001.0
Pernambuco;Área 002;36039;36039;36039;0;0;2609907003002.0
Pernambuco;Palmares;59526;59526;59503;23;0;2610004.0
Pernambuco;Área 001;24514;24514;24514;0;0;2610004003001.0
Pernambuco;Área 002;35012;35012;34989;23;0;2610004003002.0
Pernambuco;Paudalho;51357;51357;51357;0;0;2610608.0
Pernambuco;Área 001;24088;24088;24088;0;0;2610608003001.0
Pernambuco;Área 002;27269;27269;27269;0;0;2610608003002.0
Pernambuco;Paulista;300466;300293;300226;67;173;2610707.0
Pernambuco;Área 001;16913;16913;16901;12;0;2610707003001.0
Pernambuco;Área 002;12372;12372;12372;0;0;2610707003002.0
Pernambuco;Área 003;15737;15737;15737;0;0;2610707003003.0
Pernambuco;Área 004;30352;30352;30352;0;0;2610707003004.0
Pernambuco;Área 005;54152;54141;54141;0;11;2610707003005.0
Pernambuco;Área 006;14714;14704;14704;0;10;2610707003006.0
Pernambuco;Área 007;14798;14764;14764;0;34;2610707003007.0
Pernambuco;Área 008;17186;17144;17144;0;42;2610707003008.0
Pernambuco;Área 009;16307;16307;16299;8;0;2610707003009.0
Pernambuco;Área 010;20687;20666;20655;11;21;2610707003010.0
Pernambuco;Área 011;16383;16383;16383;0;0;2610707003011.0
Pernambuco;Área 012;35948;35893;35871;22;55;2610707003012.0
Pernambuco;Área 013;34917;34917;34903;14;0;2610707003013.0
Pernambuco;Pesqueira;62931;62931;62931;0;0;2610905.0
Pernambuco;Área 001;15860;15860;15860;0;0;2610905003001.0
Pernambuco;Área 002;22858;22858;22858;0;0;2610905003002.0
Pernambuco;Área 003;24213;24213;24213;0;0;2610905003003.0
Pernambuco;Petrolândia;32492;32488;32488;0;4;2611002.0
Pernambuco;Área 001;14878;14874;14874;0;4;2611002003001.0
Pernambuco;Área 002;17614;17614;17614;0;0;2611002003002.0
Pernambuco;Petrolina;293962;293906;293884;22;56;2611101.0
Pernambuco;Área 001;15153;15153;15153;0;0;2611101003001.0
Pernambuco;Área 002;16450;16428;16415;12;22;2611101003002.0
Pernambuco;Área 003;18610;18610;18600;10;0;2611101003003.0
Pernambuco;Área 004;17623;17623;17623;0;0;2611101003004.0
Pernambuco;Área 005;15502;15502;15502;0;0;2611101003005.0
Pernambuco;Área 006;19729;19729;19729;0;0;2611101003006.0
Pernambuco;Área 007;19807;19795;19795;0;12;2611101003007.0
Pernambuco;Área 008;24384;24384;24384;0;0;2611101003008.0
Pernambuco;Área 009;23635;23635;23635;0;0;2611101003009.0
Pernambuco;Área 010;27085;27085;27085;0;0;2611101003010.0
Pernambuco;Área 011;14948;14948;14948;0;0;2611101003011.0
Pernambuco;Área 012;18274;18274;18274;0;0;2611101003012.0
Pernambuco;Área 013;27800;27778;27778;0;22;2611101003013.0
Pernambuco;Área 014;34962;34962;34962;0;0;2611101003014.0
Pernambuco;Recife;1537704;1535289;1534231;1057;2415;2611606.0
Pernambuco;Área 001;31388;31366;31324;42;22;2611606005001.0
Pernambuco;Área 002;46726;46586;46549;37;140;2611606005002.0
Pernambuco;Área 003;53461;53401;53387;14;60;2611606005003.0
Pernambuco;Área 004;29012;28933;28933;0;79;2611606005004.0
Pernambuco;Área 005;43529;43514;43514;0;15;2611606005005.0
Pernambuco;Área 006;31285;31285;31258;27;0;2611606005006.0
Pernambuco;Área 007;31042;31042;31042;0;0;2611606005007.0
Pernambuco;Área 008;32905;32905;32905;0;0;2611606005008.0
Pernambuco;Área 009;38820;38565;38439;125;255;2611606005009.0
Pernambuco;Área 010;26405;26355;26330;25;50;2611606005010.0
Pernambuco;Área 011;33835;33784;33784;0;51;2611606005011.0
Pernambuco;Área 012;30466;30347;30310;37;119;2611606005012.0
Pernambuco;Área 013;41928;41912;41912;0;16;2611606005013.0
Pernambuco;Área 014;31025;31025;31025;0;0;2611606005014.0
Pernambuco;Área 015;34212;34195;34195;0;17;2611606005015.0
Pernambuco;Área 016;29559;29511;29511;0;48;2611606005016.0
Pernambuco;Área 017;46731;46731;46731;0;0;2611606005017.0
Pernambuco;Área 018;26822;26822;26754;68;0;2611606005018.0
Pernambuco;Área 019;35630;35560;35502;58;70;2611606005019.0
Pernambuco;Área 020;41164;41073;41073;0;91;2611606005020.0
Pernambuco;Área 021;42226;42226;42226;0;0;2611606005021.0
Pernambuco;Área 022;52200;52182;52140;42;18;2611606005022.0
Pernambuco;Área 023;52764;52582;52563;19;182;2611606005023.0
Pernambuco;Área 024;28141;28128;28128;0;13;2611606005024.0
Pernambuco;Área 025;36265;36240;36240;0;25;2611606005025.0
Pernambuco;Área 026;54420;54398;54363;36;22;2611606005026.0
Pernambuco;Área 027;59849;59809;59769;40;40;2611606005027.0
Pernambuco;Área 028;30935;30935;30935;0;0;2611606005028.0
Pernambuco;Área 029;41478;41478;41478;0;0;2611606005029.0
Pernambuco;Área 030;40831;40831;40831;0;0;2611606005030.0
Pernambuco;Área 031;47510;47510;47485;25;0;2611606005031.0
Pernambuco;Área 032;39702;39375;39167;208;327;2611606005032.0
Pernambuco;Área 033;49516;49030;48871;159;486;2611606005033.0
Pernambuco;Área 034;33704;33531;33506;25;173;2611606005034.0
Pernambuco;Área 035;34166;34144;34144;0;22;2611606005035.0
Pernambuco;Área 036;39375;39299;39272;28;76;2611606005036.0
Pernambuco;Área 037;26862;26862;26862;0;0;2611606005037.0
Pernambuco;Área 038;44532;44532;44510;22;0;2611606005038.0
Pernambuco;Área 039;37469;37469;37448;21;0;2611606005039.0
Pernambuco;Área 040;29814;29814;29814;0;0;2611606005040.0
Pernambuco;Ribeirão;44439;44439;44439;0;0;2611804.0
Pernambuco;Área 001;14560;14560;14560;0;0;2611804003001.0
Pernambuco;Área 002;29879;29879;29879;0;0;2611804003002.0
Pernambuco;Salgueiro;56629;56629;56629;0;0;2612208.0
Pernambuco;Área 001;24067;24067;24067;0;0;2612208003001.0
Pernambuco;Área 002;32562;32562;32562;0;0;2612208003002.0
Pernambuco;Santa Cruz do Capibaribe;87582;87571;87571;0;11;2612505.0
Pernambuco;Área 001;15258;15247;15247;0;11;2612505003001.0
Pernambuco;Área 002;13986;13986;13986;0;0;2612505003002.0
Pernambuco;Área 003;28716;28716;28716;0;0;2612505003003.0
Pernambuco;Área 004;29622;29622;29622;0;0;2612505003004.0
Pernambuco;Santa Maria da Boa Vista;39435;39435;39435;0;0;2612604.0
Pernambuco;Área 001;16472;16472;16472;0;0;2612604003001.0
Pernambuco;Área 002;22963;22963;22963;0;0;2612604003002.0
Pernambuco;São Bento do Una;53242;53242;53242;0;0;2613008.0
Pernambuco;Área 001;24582;24582;24582;0;0;2613008003001.0
Pernambuco;Área 002;28660;28660;28660;0;0;2613008003002.0
Pernambuco;São Caitano;35274;35274;35274;0;0;2613107.0
Pernambuco;Área 001;12920;12920;12920;0;0;2613107003001.0
Pernambuco;Área 002;22354;22354;22354;0;0;2613107003002.0
Pernambuco;São José do Egito;31829;31817;31817;0;12;2613602.0
Pernambuco;Área 001;13102;13090;13090;0;12;2613602003001.0
Pernambuco;Área 002;18727;18727;18727;0;0;2613602003002.0
Pernambuco;São Lourenço da Mata;102895;102880;102866;15;15;2613701.0
Pernambuco;Área 001;15307;15307;15307;0;0;2613701003001.0
Pernambuco;Área 002;18420;18405;18391;15;15;2613701003002.0
Pernambuco;Área 003;19521;19521;19521;0;0;2613701003003.0
Pernambuco;Área 004;20509;20509;20509;0;0;2613701003004.0
Pernambuco;Área 005;29138;29138;29138;0;0;2613701003005.0
Pernambuco;Serra Talhada;79232;79232;79232;0;0;2613909.0
Pernambuco;Área 001;21484;21484;21484;0;0;2613909003001.0
Pernambuco;Área 002;24646;24646;24646;0;0;2613909003002.0
Pernambuco;Área 003;33102;33102;33102;0;0;2613909003003.0
Pernambuco;Sertânia;33787;33787;33782;5;0;2614105.0
Pernambuco;Área 001;15408;15408;15403;5;0;2614105003001.0
Pernambuco;Área 002;18379;18379;18379;0;0;2614105003002.0
Pernambuco;Sirinhaém;40296;40286;40276;10;10;2614204.0
Pernambuco;Área 001;18785;18785;18785;0;0;2614204003001.0
Pernambuco;Área 002;21511;21501;21491;10;10;2614204003002.0
Pernambuco;Surubim;58515;58515;58515;0;0;2614501.0
Pernambuco;Área 001;15045;15045;15045;0;0;2614501003001.0
Pernambuco;Área 002;17738;17738;17738;0;0;2614501003002.0
Pernambuco;Área 003;25732;25732;25732;0;0;2614501003003.0
Pernambuco;Timbaúba;53825;53825;53825;0;0;2615300.0
Pernambuco;Área 001;19539;19539;19539;0;0;2615300003001.0
Pernambuco;Área 002;34286;34286;34286;0;0;2615300003002.0
Pernambuco;Toritama;35554;35554;35542;12;0;2615409.0
Pernambuco;Área 001;16452;16452;16440;12;0;2615409003001.0
Pernambuco;Área 002;19102;19102;19102;0;0;2615409003002.0
Pernambuco;Vitória de Santo Antão;129974;129962;129962;0;12;2616407.0
Pernambuco;Área 001;29380;29368;29368;0;12;2616407003001.0
Pernambuco;Área 002;21762;21762;21762;0;0;2616407003002.0
Pernambuco;Área 003;13806;13806;13806;0;0;2616407003003.0
Pernambuco;Área 004;13156;13156;13156;0;0;2616407003004.0
Pernambuco;Área 005;25869;25869;25869;0;0;2616407003005.0
Pernambuco;Área 006;26001;26001;26001;0;0;2616407003006.0
Alagoas;Arapiraca;214006;214006;213974;32;0;2700300.0
Alagoas;Área 001;14992;14992;14992;0;0;2700300004001.0
Alagoas;Área 002;14669;14669;14663;6;0;2700300004002.0
Alagoas;Área 003;14659;14659;14659;0;0;2700300004003.0
Alagoas;Área 004;15271;15271;15271;0;0;2700300004004.0
Alagoas;Área 005;15236;15236;15236;0;0;2700300004005.0
Alagoas;Área 006;15488;15488;15488;0;0;2700300004006.0
Alagoas;Área 007;17200;17200;17200;0;0;2700300004007.0
Alagoas;Área 008;17699;17699;17699;0;0;2700300004008.0
Alagoas;Área 009;15620;15620;15620;0;0;2700300004009.0
Alagoas;Área 010;17272;17272;17272;0;0;2700300004010.0
Alagoas;Área 011;28824;28824;28824;0;0;2700300004011.0
Alagoas;Área 012;27076;27076;27050;26;0;2700300004012.0
Alagoas;Atalaia;44322;44322;44322;0;0;2700409.0
Alagoas;Área 001;19141;19141;19141;0;0;2700409003001.0
Alagoas;Área 002;25181;25181;25181;0;0;2700409003002.0
Alagoas;Campo Alegre;50816;50816;50816;0;0;2701407.0
Alagoas;Área 001;15419;15419;15419;0;0;2701407003001.0
Alagoas;Área 002;35397;35397;35397;0;0;2701407003002.0
Alagoas;Coruripe;52130;52118;52118;0;12;2702306.0
Alagoas;Área 001;24453;24453;24453;0;0;2702306003001.0
Alagoas;Área 002;27677;27665;27665;0;12;2702306003002.0
Alagoas;Delmiro Gouveia;48096;48096;48096;0;0;2702405.0
Alagoas;Área 001;24016;24016;24016;0;0;2702405003001.0
Alagoas;Área 002;24080;24080;24080;0;0;2702405003002.0
Alagoas;Girau do Ponciano;36600;36600;36600;0;0;2702900.0
Alagoas;Área 001;17795;17795;17795;0;0;2702900003001.0
Alagoas;Área 002;18805;18805;18805;0;0;2702900003002.0
Alagoas;Maceió;932748;932134;931911;223;614;2704302.0
Alagoas;Área 001;28824;28824;28824;0;0;2704302004001.0
Alagoas;Área 002;30214;30214;30214;0;0;2704302004002.0
Alagoas;Área 003;25376;25229;25210;19;147;2704302004003.0
Alagoas;Área 004;33035;33035;32994;41;0;2704302004004.0
Alagoas;Área 005;35114;35114;35114;0;0;2704302004005.0
Alagoas;Área 006;39222;39222;39222;0;0;2704302004006.0
Alagoas;Área 007;139202;139181;139181;0;21;2704302004007.0
Alagoas;Área 008;40489;40489;40489;0;0;2704302004008.0
Alagoas;Área 009;36912;36912;36912;0;0;2704302004009.0
Alagoas;Área 010;35881;35866;35844;22;15;2704302004010.0
Alagoas;Área 011;25636;25551;25517;34;85;2704302004011.0
Alagoas;Área 012;45082;45082;45070;12;0;2704302004012.0
Alagoas;Área 013;41814;41814;41814;0;0;2704302004013.0
Alagoas;Área 014;32026;32006;32006;0;20;2704302004014.0
Alagoas;Área 015;35733;35633;35633;0;100;2704302004015.0
Alagoas;Área 016;81030;80930;80930;0;100;2704302004016.0
Alagoas;Área 017;30877;30771;30733;38;106;2704302004017.0
Alagoas;Área 018;34534;34534;34497;37;0;2704302004018.0
Alagoas;Área 019;31215;31215;31215;0;0;2704302004019.0
Alagoas;Área 020;28402;28402;28382;20;0;2704302004020.0
Alagoas;Área 021;48172;48172;48172;0;0;2704302004021.0
Alagoas;Área 022;53958;53939;53939;0;19;2704302004022.0
Alagoas;Marechal Deodoro;45977;45921;45910;11;56;2704708.0
Alagoas;Área 001;16083;16083;16083;0;0;2704708003001.0
Alagoas;Área 002;29894;29838;29827;11;56;2704708003002.0
Alagoas;Palmeira dos Índios;70368;70368;70368;0;0;2706307.0
Alagoas;Área 001;14075;14075;14075;0;0;2706307003001.0
Alagoas;Área 002;28549;28549;28549;0;0;2706307003002.0
Alagoas;Área 003;27744;27744;27744;0;0;2706307003003.0
Alagoas;Penedo;60378;60368;60356;12;10;2706703.0
Alagoas;Área 001;18357;18347;18347;0;10;2706703003001.0
Alagoas;Área 002;42021;42021;42009;12;0;2706703003002.0
Alagoas;Pilar;33305;33305;33305;0;0;2706901.0
Alagoas;Área 001;15995;15995;15995;0;0;2706901003001.0
Alagoas;Área 002;17310;17310;17310;0;0;2706901003002.0
Alagoas;Rio Largo;68481;68481;68481;0;0;2707701.0
Alagoas;Área 001;17292;17292;17292;0;0;2707701003001.0
Alagoas;Área 002;21911;21911;21911;0;0;2707701003002.0
Alagoas;Área 003;29278;29278;29278;0;0;2707701003003.0
Alagoas;Santana do Ipanema;44932;44932;44927;5;0;2708006.0
Alagoas;Área 001;20326;20326;20326;0;0;2708006003001.0
Alagoas;Área 002;24606;24606;24601;5;0;2708006003002.0
Alagoas;São Miguel dos Campos;54577;54577;54577;0;0;2708600.0
Alagoas;Área 001;26126;26126;26126;0;0;2708600003001.0
Alagoas;Área 002;28451;28451;28451;0;0;2708600003002.0
Alagoas;Teotônio Vilela;41152;41152;41152;0;0;2709152.0
Alagoas;Área 001;16989;16989;16989;0;0;2709152003001.0
Alagoas;Área 002;24163;24163;24163;0;0;2709152003002.0
Alagoas;União dos Palmares;62358;62352;62344;8;6;2709301.0
Alagoas;Área 001;14790;14784;14776;8;6;2709301003001.0
Alagoas;Área 002;15943;15943;15943;0;0;2709301003002.0
Alagoas;Área 003;31625;31625;31625;0;0;2709301003003.0
Sergipe;Aracaju;571149;570674;570657;17;475;2800308.0
Sergipe;18 do Forte;39050;38998;38998;0;52;2800308005012.0
Sergipe;América;40943;40943;40943;0;0;2800308005016.0
Sergipe;Área de Expansão;27899;27899;27899;0;0;2800308005001.0
Sergipe;Cidade Nova;39687;39687;39687;0;0;2800308005013.0
Sergipe;Coroa do Meio;41241;41168;41151;17;73;2800308005005.0
Sergipe;Farolândia;38257;38257;38257;0;0;2800308005004.0
Sergipe;Grageru;42446;42145;42145;0;301;2800308005007.0
Sergipe;Industrial;37231;37231;37231;0;0;2800308005011.0
Sergipe;Jabotiana;31044;31044;31044;0;0;2800308005006.0
Sergipe;Luzia;26372;26372;26372;0;0;2800308005008.0
Sergipe;Olaria;31402;31402;31402;0;0;2800308005015.0
Sergipe;Ponto Novo;37287;37238;37238;0;49;2800308005009.0
Sergipe;Santa Maria;33475;33475;33475;0;0;2800308005002.0
Sergipe;Santos Dumont;43581;43581;43581;0;0;2800308005014.0
Sergipe;São Conrado;30675;30675;30675;0;0;2800308005003.0
Sergipe;Suiça;30559;30559;30559;0;0;2800308005010.0
Sergipe;Estância;64409;64409;64409;0;0;2802106.0
Sergipe;Área 001;16729;16729;16729;0;0;2802106003001.0
Sergipe;Área 002;23419;23419;23419;0;0;2802106003002.0
Sergipe;Área 003;24261;24261;24261;0;0;2802106003003.0
Sergipe;Itabaiana;86967;86967;86967;0;0;2802908.0
Sergipe;Área 001;14716;14716;14716;0;0;2802908003001.0
Sergipe;Área 002;22262;22262;22262;0;0;2802908003002.0
Sergipe;Área 003;25000;25000;25000;0;0;2802908003003.0
Sergipe;Área 004;24989;24989;24989;0;0;2802908003004.0
Sergipe;Itabaianinha;38910;38910;38910;0;0;2803005.0
Sergipe;Área 001;15016;15016;15016;0;0;2803005003001.0
Sergipe;Área 002;23894;23894;23894;0;0;2803005003002.0
Sergipe;Itaporanga d'Ajuda;30419;30419;30419;0;0;2803203.0
Sergipe;Área 001;15253;15253;15253;0;0;2803203003001.0
Sergipe;Área 002;15166;15166;15166;0;0;2803203003002.0
Sergipe;Lagarto;94861;94861;94861;0;0;2803500.0
Sergipe;Área 001;15985;15985;15985;0;0;2803500003001.0
Sergipe;Área 002;15842;15842;15842;0;0;2803500003002.0
Sergipe;Área 003;17514;17514;17514;0;0;2803500003003.0
Sergipe;Área 004;17870;17870;17870;0;0;2803500003004.0
Sergipe;Área 005;27650;27650;27650;0;0;2803500003005.0
Sergipe;Nossa Senhora do Socorro;160827;160815;160807;8;12;2804805.0
Sergipe;Área 001;14566;14566;14566;0;0;2804805003001.0
Sergipe;Área 002;16859;16847;16847;0;12;2804805003002.0
Sergipe;Área 003;14275;14275;14275;0;0;2804805003003.0
Sergipe;Área 004;17080;17080;17080;0;0;2804805003004.0
Sergipe;Área 005;22488;22488;22488;0;0;2804805003005.0
Sergipe;Área 006;20342;20342;20342;0;0;2804805003006.0
Sergipe;Área 007;27107;27107;27099;8;0;2804805003007.0
Sergipe;Área 008;28110;28110;28110;0;0;2804805003008.0
Sergipe;São Cristóvão;78864;78864;78864;0;0;2806701.0
Sergipe;Área 001;14527;14527;14527;0;0;2806701003001.0
Sergipe;Área 002;15706;15706;15706;0;0;2806701003002.0
Sergipe;Área 003;24050;24050;24050;0;0;2806701003003.0
Sergipe;Área 004;24581;24581;24581;0;0;2806701003004.0
Sergipe;Simão Dias;38702;38702;38702;0;0;2807105.0
Sergipe;Área 001;14522;14522;14522;0;0;2807105003001.0
Sergipe;Área 002;24180;24180;24180;0;0;2807105003002.0
Sergipe;Tobias Barreto;48040;48040;48040;0;0;2807402.0
Sergipe;Área 001;21635;21635;21635;0;0;2807402003001.0
Sergipe;Área 002;26405;26405;26405;0;0;2807402003002.0
Bahia;Alagoinhas;141949;141929;141905;24;20;2900702.0
Bahia;Área 001;14559;14559;14559;0;0;2900702003001.0
Bahia;Área 002;14445;14434;14434;0;11;2900702003002.0
Bahia;Área 003;21450;21450;21450;0;0;2900702003003.0
Bahia;Área 004;14845;14845;14845;0;0;2900702003004.0
Bahia;Área 005;17151;17142;17131;11;9;2900702003005.0
Bahia;Área 006;27765;27765;27765;0;0;2900702003006.0
Bahia;Área 007;31734;31734;31721;13;0;2900702003007.0
Bahia;Amargosa;34351;34337;34337;0;14;2901007.0
Bahia;Área 001;16549;16549;16549;0;0;2901007003001.0
Bahia;Área 002;17802;17788;17788;0;14;2901007003002.0
Bahia;Aporá;17731;17731;17731;0;0;2901908.0
Bahia;Distrito 05 de Aporá;7685;7685;7685;0;0;2901908002001.0
Bahia;Distrito 10 de Aporá;10046;10046;10046;0;0;2901908002002.0
Bahia;Araci;51651;51651;51651;0;0;2902104.0
Bahia;Área 001;24274;24274;24274;0;0;2902104003001.0
Bahia;Área 002;27377;27377;27377;0;0;2902104003002.0
Bahia;Barra;49325;49325;49325;0;0;2902708.0
Bahia;Área 001;17350;17350;17350;0;0;2902708003001.0
Bahia;Área 002;31975;31975;31975;0;0;2902708003002.0
Bahia;Barra do Choça;34788;34775;34763;12;13;2902906.0
Bahia;Área 001;16239;16239;16239;0;0;2902906003001.0
Bahia;Área 002;18549;18536;18524;12;13;2902906003002.0
Bahia;Barreiras;137427;137381;137339;41;46;2903201.0
Bahia;Área 001;14449;14442;14442;0;7;2903201003001.0
Bahia;Área 002;17458;17438;17430;8;20;2903201003002.0
Bahia;Área 003;18226;18217;18196;21;9;2903201003003.0
Bahia;Área 004;19625;19625;19625;0;0;2903201003004.0
Bahia;Área 005;15800;15800;15800;0;0;2903201003005.0
Bahia;Área 006;22212;22212;22212;0;0;2903201003006.0
Bahia;Área 007;29657;29647;29636;11;10;2903201003007.0
Bahia;Bom Jesus da Lapa;63480;63453;63453;0;27;2903904.0
Bahia;Área 001;30718;30708;30708;0;10;2903904003001.0
Bahia;Área 002;32762;32746;32746;0;16;2903904003002.0
Bahia;Brumado;64602;64602;64602;0;0;2904605.0
Bahia;Área 001;17695;17695;17695;0;0;2904605003001.0
Bahia;Área 002;22772;22772;22772;0;0;2904605003002.0
Bahia;Área 003;24135;24135;24135;0;0;2904605003003.0
Bahia;Cachoeira;32026;32008;32008;0;18;2904902.0
Bahia;Área 001;14982;14982;14982;0;0;2904902003001.0
Bahia;Área 002;17044;17026;17026;0;18;2904902003002.0
Bahia;Caetité;47515;47488;47488;0;27;2905206.0
Bahia;Área 001;19470;19443;19443;0;27;2905206003001.0
Bahia;Área 002;28045;28045;28045;0;0;2905206003002.0
Bahia;Camacan;31472;31472;31465;7;0;2905602.0
Bahia;Área 001;14402;14402;14395;7;0;2905602003001.0
Bahia;Área 002;17070;17070;17070;0;0;2905602003002.0
Bahia;Camaçari;242970;242600;242489;111;370;2905701.0
Bahia;Catu de Abrantes, Buris de Abrantes, Abrantes;25948;25923;25911;12;25;2905701005004.0
Bahia;Centro, Dois de Julho, Jardim Brasilia, Alto da Cruz, Bela Vista,Ponto Certo, Piaçaveira, Dom Avelar;27273;27265;27240;25;8;2905701005006.0
Bahia;Espaço Alpha, Limoeiro, Parque das Mangabas, Monte Negro, Verdes Horizontes, Parafuso, Parque Verde 1 e 2;28853;28853;28853;0;0;2905701005011.0
Bahia;Ficam, Parque Satélite, Vila Irmã Dulce, Parque Florestal, Natal, Gleba B;17383;17374;17374;0;9;2905701005005.0
Bahia;Gleba A, Gravatá, Vila Goiania, Mangueiral, Cristo Redentor, Alto do Triângulo e Triângulo;15797;15797;15797;0;0;2905701005001.0
Bahia;Itacimirim,Guarajuba,Barra do Jacuipe, Vale da Landirana,Arembepe,Abrantes;14111;13982;13943;39;129;2905701005012.0
Bahia;Lama Preta, Burissatuba, Gleba H;21417;21403;21403;0;14;2905701005008.0
Bahia;Monte Gordo, Barra do Pojuca;19853;19703;19687;16;150;2905701005002.0
Bahia;Nova Aliança (PHOC I), Tancredo Neves (PHOC III), Gleba E, Recanto das Árvores;16672;16672;16653;19;0;2905701005010.0
Bahia;Novo Horizonte, Nova Vitória, Pólo de Apoio;15444;15444;15444;0;0;2905701005009.0
Bahia;Quarenta e Seis, Gleba C, Acajutiba, Renascer-Phoc 2;19909;19909;19909;0;0;2905701005007.0
Bahia;Rural;20310;20274;20274;0;36;2905701005003.0
Bahia;Campo Formoso;66616;66616;66605;11;0;2906006.0
Bahia;Área 001;32255;32255;32244;11;0;2906006003001.0
Bahia;Área 002;34361;34361;34361;0;0;2906006003002.0
Bahia;Canavieiras;32336;32200;32191;8;136;2906303.0
Bahia;Área 001;13151;13068;13060;8;83;2906303003001.0
Bahia;Área 002;19185;19132;19132;0;53;2906303003002.0
Bahia;Candeias;83158;83158;83158;0;0;2906501.0
Bahia;Área 001;13794;13794;13794;0;0;2906501003001.0
Bahia;Área 002;14157;14157;14157;0;0;2906501003002.0
Bahia;Área 003;27413;27413;27413;0;0;2906501003003.0
Bahia;Área 004;27794;27794;27794;0;0;2906501003004.0
Bahia;Cansanção;32908;32908;32908;0;0;2906808.0
Bahia;Área 001;15658;15658;15658;0;0;2906808003001.0
Bahia;Área 002;17250;17250;17250;0;0;2906808003002.0
Bahia;Capim Grosso;26577;26563;26563;0;14;2906873.0
Bahia;Área 001;12424;12424;12424;0;0;2906873003001.0
Bahia;Área 002;14153;14139;14139;0;14;2906873003002.0
Bahia;Casa Nova;64940;64920;64920;0;20;2907202.0
Bahia;Área 001;25560;25540;25540;0;20;2907202003001.0
Bahia;Área 002;39380;39380;39380;0;0;2907202003002.0
Bahia;Catu;51077;51033;51033;0;44;2907509.0
Bahia;Área 001;25299;25280;25280;0;19;2907509003001.0
Bahia;Área 002;25778;25753;25753;0;25;2907509003002.0
Bahia;Cícero Dantas;32300;32300;32300;0;0;2907806.0
Bahia;Área 001;14802;14802;14802;0;0;2907806003001.0
Bahia;Área 002;17498;17498;17498;0;0;2907806003002.0
Bahia;Conceição do Coité;62040;62040;62040;0;0;2908408.0
Bahia;Área 001;12585;12585;12585;0;0;2908408003001.0
Bahia;Área 002;20729;20729;20729;0;0;2908408003002.0
Bahia;Área 003;28726;28726;28726;0;0;2908408003003.0
Bahia;Correntina;31249;31249;31249;0;0;2909307.0
Bahia;Área 001;14006;14006;14006;0;0;2909307003001.0
Bahia;Área 002;17243;17243;17243;0;0;2909307003002.0
Bahia;Cruz das Almas;58606;58533;58505;28;73;2909802.0
Bahia;Área 001;17154;17154;17154;0;0;2909802003001.0
Bahia;Área 002;15719;15708;15708;0;11;2909802003002.0
Bahia;Área 003;25733;25671;25643;28;62;2909802003003.0
Bahia;Dias d'Ávila;66440;66381;66359;22;59;2910057.0
Bahia;Área 001;14490;14477;14463;14;13;2910057003001.0
Bahia;Área 002;25149;25113;25106;7;36;2910057003002.0
Bahia;Área 003;26801;26791;26791;0;10;2910057003003.0
Bahia;Entre Rios;39872;39817;39817;0;55;2910503.0
Bahia;Área 001;16178;16178;16178;0;0;2910503003001.0
Bahia;Área 002;23694;23639;23639;0;55;2910503003002.0
Bahia;Esplanada;32802;32802;32802;0;0;2910602.0
Bahia;Área 001;15688;15688;15688;0;0;2910602003001.0
Bahia;Área 002;17114;17114;17114;0;0;2910602003002.0
Bahia;Euclides da Cunha;56289;56289;56289;0;0;2910701.0
Bahia;Área 001;28159;28159;28159;0;0;2910701003001.0
Bahia;Área 002;28130;28130;28130;0;0;2910701003002.0
Bahia;Eunápolis;100196;100143;100113;30;53;2910727.0
Bahia;Área 001;13264;13249;13249;0;15;2910727003001.0
Bahia;Área 002;17083;17083;17083;0;0;2910727003002.0
Bahia;Área 003;19079;19069;19061;8;10;2910727003003.0
Bahia;Área 004;23632;23632;23632;0;0;2910727003004.0
Bahia;Área 005;27138;27110;27089;22;28;2910727003005.0
Bahia;Feira de Santana;556642;556393;556310;83;249;2910800.0
Bahia;Área 001;32183;32183;32183;0;0;2910800004001.0
Bahia;Área 002;31060;31037;31022;15;23;2910800004002.0
Bahia;Área 003;30558;30377;30348;29;181;2910800004003.0
Bahia;Área 004;38311;38311;38311;0;0;2910800004004.0
Bahia;Área 005;45596;45596;45596;0;0;2910800004005.0
Bahia;Área 006;31006;31006;30968;38;0;2910800004006.0
Bahia;Área 007;34778;34778;34778;0;0;2910800004007.0
Bahia;Área 008;33614;33614;33614;0;0;2910800004008.0
Bahia;Área 009;37530;37530;37530;0;0;2910800004009.0
Bahia;Área 010;42216;42216;42216;0;0;2910800004010.0
Bahia;Área 011;42864;42864;42864;0;0;2910800004011.0
Bahia;Área 012;39629;39629;39629;0;0;2910800004012.0
Bahia;Área 013;58691;58691;58691;0;0;2910800004013.0
Bahia;Área 014;58606;58561;58561;0;45;2910800004014.0
Bahia;Gandu;30336;30336;30336;0;0;2911204.0
Bahia;Área 001;13623;13623;13623;0;0;2911204003001.0
Bahia;Área 002;16713;16713;16713;0;0;2911204003002.0
Bahia;Guanambi;78833;78833;78833;0;0;2911709.0
Bahia;Área 001;15443;15443;15443;0;0;2911709003001.0
Bahia;Área 002;19245;19245;19245;0;0;2911709003002.0
Bahia;Área 003;21992;21992;21992;0;0;2911709003003.0
Bahia;Área 004;22153;22153;22153;0;0;2911709003004.0
Bahia;Ibicoara;17282;17282;17282;0;0;2912202.0
Bahia;Distrito 05 de Ibicoara;8013;8013;8013;0;0;2912202002001.0
Bahia;Distrito 15 de Ibicoara;9269;9269;9269;0;0;2912202002002.0
Bahia;Ilhéus;184236;183820;183624;196;416;2913606.0
Bahia;Área 001;19093;19081;19081;0;12;2913606003001.0
Bahia;Área 002;16081;16070;16070;0;11;2913606003002.0
Bahia;Área 003;18059;18039;18022;17;20;2913606003003.0
Bahia;Área 004;18385;18312;18270;42;73;2913606003004.0
Bahia;Área 005;14285;14217;14161;57;68;2913606003005.0
Bahia;Área 006;15914;15914;15914;0;0;2913606003006.0
Bahia;Área 007;21499;21489;21476;13;10;2913606003007.0
Bahia;Área 008;26410;26401;26401;0;9;2913606003008.0
Bahia;Área 009;34510;34297;34230;67;213;2913606003009.0
Bahia;Ipiaú;44390;44390;44390;0;0;2913903.0
Bahia;Área 001;19779;19779;19779;0;0;2913903003001.0
Bahia;Área 002;24611;24611;24611;0;0;2913903003002.0
Bahia;Ipirá;59343;59343;59343;0;0;2914000.0
Bahia;Área 001;16688;16688;16688;0;0;2914000003001.0
Bahia;Área 002;16321;16321;16321;0;0;2914000003002.0
Bahia;Área 003;26334;26334;26334;0;0;2914000003003.0
Bahia;Irecê;66181;66181;66181;0;0;2914604.0
Bahia;Área 001;13134;13134;13134;0;0;2914604003001.0
Bahia;Área 002;26142;26142;26142;0;0;2914604003002.0
Bahia;Área 003;26905;26905;26905;0;0;2914604003003.0
Bahia;Itaberaba;61631;61631;61621;10;0;2914703.0
Bahia;Área 001;14129;14129;14119;10;0;2914703003001.0
Bahia;Área 002;22795;22795;22795;0;0;2914703003002.0
Bahia;Área 003;24707;24707;24707;0;0;2914703003003.0
Bahia;Itabuna;204667;204514;204459;55;153;2914802.0
Bahia;1480-Área 01;16557;16557;16557;0;0;2914802005001.0
Bahia;1480-Área 02;14777;14760;14760;0;17;2914802005002.0
Bahia;1480-Área 03;13287;13277;13261;17;10;2914802005003.0
Bahia;1480-Área 04;14985;14985;14985;0;0;2914802005004.0
Bahia;1480-Área 05;13222;13192;13171;21;30;2914802005005.0
Bahia;1480-Área 06;15525;15525;15525;0;0;2914802005006.0
Bahia;1480-Área 07;14481;14481;14481;0;0;2914802005007.0
Bahia;1480-Área 08;14686;14679;14679;0;7;2914802005008.0
Bahia;1480-Área 09;14261;14261;14261;0;0;2914802005009.0
Bahia;1480-Área 10;12444;12408;12408;0;36;2914802005010.0
Bahia;1480-Área 11;15540;15510;15492;17;30;2914802005011.0
Bahia;1480-Área 12;14196;14183;14183;0;13;2914802005012.0
Bahia;1480-Área 13;13791;13781;13781;0;10;2914802005013.0
Bahia;1480-Área 14;16915;16915;16915;0;0;2914802005014.0
Bahia;Itamaraju;63069;63058;63048;10;11;2915601.0
Bahia;Área 001;31423;31423;31423;0;0;2915601003001.0
Bahia;Área 002;31646;31635;31625;10;11;2915601003002.0
Bahia;Itapetinga;68273;68255;68255;0;18;2916401.0
Bahia;Área 001;15764;15764;15764;0;0;2916401003001.0
Bahia;Área 002;26062;26054;26054;0;8;2916401003002.0
Bahia;Área 003;26447;26437;26437;0;10;2916401003003.0
Bahia;Itapicuru;32261;32261;32261;0;0;2916500.0
Bahia;Área 001;15756;15756;15756;0;0;2916500003001.0
Bahia;Área 002;16505;16505;16505;0;0;2916500003002.0
Bahia;Itiúba;36113;36113;36113;0;0;2917003.0
Bahia;Área 001;17446;17446;17446;0;0;2917003003001.0
Bahia;Área 002;18667;18667;18667;0;0;2917003003002.0
Bahia;Jacobina;79247;79177;79177;0;70;2917508.0
Bahia;Área 001;12760;12760;12760;0;0;2917508003001.0
Bahia;Área 002;17877;17852;17852;0;25;2917508003002.0
Bahia;Área 003;23729;23717;23717;0;12;2917508003003.0
Bahia;Área 004;24881;24848;24848;0;33;2917508003004.0
Bahia;Jaguaquara;51011;51005;50992;14;6;2917607.0
Bahia;Área 001;22129;22123;22123;0;6;2917607003001.0
Bahia;Área 002;28882;28882;28868;14;0;2917607003002.0
Bahia;Jaguarari;30343;30343;30332;11;0;2917706.0
Bahia;Área 001;13321;13321;13310;11;0;2917706003001.0
Bahia;Área 002;17022;17022;17022;0;0;2917706003002.0
Bahia;Jequié;151895;151856;151856;0;39;2918001.0
Bahia;Área 001;15057;15049;15049;0;8;2918001003001.0
Bahia;Área 002;36649;36629;36629;0;20;2918001003002.0
Bahia;Área 003;14808;14808;14808;0;0;2918001003003.0
Bahia;Área 004;26165;26165;26165;0;0;2918001003004.0
Bahia;Área 005;16304;16304;16304;0;0;2918001003005.0
Bahia;Área 006;21540;21540;21540;0;0;2918001003006.0
Bahia;Área 007;21372;21361;21361;0;11;2918001003007.0
Bahia;Jeremoabo;37680;37680;37680;0;0;2918100.0
Bahia;Área 001;14935;14935;14935;0;0;2918100003001.0
Bahia;Área 002;22745;22745;22745;0;0;2918100003002.0
Bahia;Juazeiro;197965;197936;197912;23;29;2918407.0
Bahia;Cajueiro;23052;23052;23042;10;0;2918407005002.0
Bahia;Carnaíba-Juremal-Massaroca-Junco;15636;15626;15626;0;10;2918407005009.0
Bahia;Castelo Branco;18257;18257;18257;0;0;2918407005003.0
Bahia;Centro;15074;15074;15074;0;0;2918407005001.0
Bahia;Codevasf;24434;24434;24434;0;0;2918407005006.0
Bahia;Itaberaba;14914;14914;14914;0;0;2918407005004.0
Bahia;Itamotinga;15158;15158;15158;0;0;2918407005011.0
Bahia;João Paulo II;19935;19935;19935;0;0;2918407005005.0
Bahia;Kidé;19423;19423;19423;0;0;2918407005007.0
Bahia;Maniçoba;15835;15835;15821;14;0;2918407005010.0
Bahia;Santo Antônio;16247;16228;16228;0;19;2918407005008.0
Bahia;Lauro de Freitas;163449;162510;162335;174;939;2919207.0
Bahia;Área 001;15267;14774;14687;87;493;2919207003001.0
Bahia;Área 002;19368;19219;19203;17;149;2919207003002.0
Bahia;Área 003;14771;14771;14766;5;0;2919207003003.0
Bahia;Área 004;19461;19414;19389;24;47;2919207003004.0
Bahia;Área 005;25434;25434;25434;0;0;2919207003005.0
Bahia;Área 006;18085;18066;18066;0;19;2919207003006.0
Bahia;Área 007;23980;23941;23921;21;39;2919207003007.0
Bahia;Área 008;27083;26891;26870;20;192;2919207003008.0
Bahia;Livramento de Nossa Senhora;42693;42693;42693;0;0;2919504.0
Bahia;Área 001;17890;17890;17890;0;0;2919504003001.0
Bahia;Área 002;24803;24803;24803;0;0;2919504003002.0
Bahia;Luís Eduardo Magalhães;60105;60072;60040;32;33;2919553.0
Bahia;Área 001;14651;14651;14651;0;0;2919553003001.0
Bahia;Área 002;20511;20491;20471;20;20;2919553003002.0
Bahia;Área 003;24943;24931;24919;12;12;2919553003003.0
Bahia;Macaúbas;47051;47051;47051;0;0;2919801.0
Bahia;Área 001;17494;17494;17494;0;0;2919801003001.0
Bahia;Área 002;29557;29557;29557;0;0;2919801003002.0
Bahia;Maragogipe;42815;42800;42800;0;15;2920601.0
Bahia;Área 001;14999;14984;14984;0;15;2920601003001.0
Bahia;Área 002;27816;27816;27816;0;0;2920601003002.0
Bahia;Mata de São João;40183;40017;40017;0;166;2921005.0
Bahia;Área 001;18756;18722;18722;0;34;2921005003001.0
Bahia;Área 002;21427;21295;21295;0;132;2921005003002.0
Bahia;Monte Santo;52338;52338;52338;0;0;2921500.0
Bahia;Área 001;23922;23922;23922;0;0;2921500003001.0
Bahia;Área 002;28416;28416;28416;0;0;2921500003002.0
Bahia;Morro do Chapéu;35164;35154;35131;23;10;2921708.0
Bahia;Área 001;14893;14893;14881;12;0;2921708003001.0
Bahia;Área 002;20271;20261;20250;11;10;2921708003002.0
Bahia;Mucuri;36026;36026;36014;12;0;2922003.0
Bahia;Área 001;14501;14501;14489;12;0;2922003003001.0
Bahia;Área 002;21525;21525;21525;0;0;2922003003002.0
Bahia;Nova Viçosa;38556;38489;38470;18;67;2923001.0
Bahia;Área 001;17498;17484;17475;9;14;2923001003001.0
Bahia;Área 002;21058;21005;20995;10;53;2923001003002.0
Bahia;Paulo Afonso;108396;108396;108367;29;0;2924009.0
Bahia;Área 001;13663;13663;13658;5;0;2924009003001.0
Bahia;Área 002;14992;14992;14992;0;0;2924009003002.0
Bahia;Área 003;22362;22362;22362;0;0;2924009003003.0
Bahia;Área 004;26965;26965;26956;9;0;2924009003004.0
Bahia;Área 005;30414;30414;30399;15;0;2924009003005.0
Bahia;Poções;44701;44677;44677;0;24;2925105.0
Bahia;Área 001;22075;22051;22051;0;24;2925105003001.0
Bahia;Área 002;22626;22626;22626;0;0;2925105003002.0
Bahia;Pojuca;33066;33066;33066;0;0;2925204.0
Bahia;Área 001;15507;15507;15507;0;0;2925204003001.0
Bahia;Área 002;17559;17559;17559;0;0;2925204003002.0
Bahia;Porto Seguro;126929;126064;125942;122;865;2925303.0
Bahia;Área 001;13070;12932;12906;26;138;2925303003001.0
Bahia;Área 002;17416;17373;17336;37;43;2925303003002.0
Bahia;Área 003;14094;13665;13615;50;429;2925303003003.0
Bahia;Área 004;16062;16020;16020;0;42;2925303003004.0
Bahia;Área 005;15566;15480;15480;0;86;2925303003005.0
Bahia;Área 006;23124;23124;23124;0;0;2925303003006.0
Bahia;Área 007;27597;27471;27461;10;126;2925303003007.0
Bahia;Remanso;38957;38957;38957;0;0;2926004.0
Bahia;Área 001;22257;22257;22257;0;0;2926004003001.0
Bahia;Área 002;16700;16700;16700;0;0;2926004003002.0
Bahia;Riachão do Jacuípe;33172;33172;33172;0;0;2926301.0
Bahia;Área 001;13700;13700;13700;0;0;2926301003001.0
Bahia;Área 002;19472;19472;19472;0;0;2926301003002.0
Bahia;Ribeira do Pombal;47518;47518;47518;0;0;2926608.0
Bahia;Área 001;21011;21011;21011;0;0;2926608003001.0
Bahia;Área 002;26507;26507;26507;0;0;2926608003002.0
Bahia;Rio Real;37164;37164;37164;0;0;2927002.0
Bahia;Área 001;15406;15406;15406;0;0;2927002003001.0
Bahia;Área 002;21758;21758;21758;0;0;2927002003002.0
Bahia;Salvador;2675656;2671290;2669846;1444;4366;2927408.0
Bahia;Área 001;37838;37838;37838;0;0;2927408005001.0
Bahia;Área 002;30502;30473;30463;11;29;2927408005002.0
Bahia;Área 003;44486;44414;44396;18;72;2927408005003.0
Bahia;Área 004;36701;36159;36053;106;542;2927408005004.0
Bahia;Área 005;56029;56029;56029;0;0;2927408005005.0
Bahia;Área 006;9947;9859;9859;0;88;2927408005006.0
Bahia;Área 007;65337;65321;65321;0;16;2927408005007.0
Bahia;Área 008;45245;45175;45152;23;70;2927408005008.0
Bahia;Área 009;93611;93507;93450;57;104;2927408005009.0
Bahia;Área 010;40896;40896;40896;0;0;2927408005010.0
Bahia;Área 011;30568;30544;30525;19;24;2927408005011.0
Bahia;Área 012;58296;58296;58296;0;0;2927408005012.0
Bahia;Área 013;118754;118594;118516;78;160;2927408005013.0
Bahia;Área 014;49601;49601;49580;21;0;2927408005014.0
Bahia;Área 015;33758;33758;33758;0;0;2927408005015.0
Bahia;Área 016;6423;6363;6323;40;60;2927408005016.0
Bahia;Área 017;29490;29111;29018;93;379;2927408005017.0
Bahia;Área 018;12364;12364;12351;13;0;2927408005018.0
Bahia;Área 019;39708;39671;39671;0;37;2927408005019.0
Bahia;Área 020;37793;37484;37431;52;309;2927408005020.0
Bahia;Área 021;37667;37667;37667;0;0;2927408005021.0
Bahia;Área 022;27593;27510;27510;0;83;2927408005022.0
Bahia;Área 023;28044;28015;28015;0;29;2927408005023.0
Bahia;Área 024;48681;48681;48681;0;0;2927408005024.0
Bahia;Área 025;69228;69228;69228;0;0;2927408005025.0
Bahia;Área 026;33289;33289;33289;0;0;2927408005026.0
Bahia;Área 027;6434;6434;6434;0;0;2927408005027.0
Bahia;Área 028;26540;26521;26444;78;19;2927408005028.0
Bahia;Área 029;118154;117765;117570;195;389;2927408005029.0
Bahia;Área 030;42870;42870;42857;13;0;2927408005030.0
Bahia;Área 031;51548;51548;51522;26;0;2927408005031.0
Bahia;Área 032;65914;65914;65914;0;0;2927408005032.0
Bahia;Área 033;28733;28733;28733;0;0;2927408005033.0
Bahia;Área 034;40467;40467;40467;0;0;2927408005034.0
Bahia;Área 035;18803;18722;18671;50;81;2927408005035.0
Bahia;Área 036;28567;28507;28507;0;60;2927408005036.0
Bahia;Área 037;51088;51088;51088;0;0;2927408005037.0
Bahia;Área 038;62246;62223;62201;22;23;2927408005038.0
Bahia;Área 039;25010;25010;25010;0;0;2927408005039.0
Bahia;Área 040;64259;64259;64259;0;0;2927408005040.0
Bahia;Área 041;76316;76254;76254;0;62;2927408005041.0
Bahia;Área 042;36475;36475;36475;0;0;2927408005042.0
Bahia;Área 043;34347;34071;34054;16;276;2927408005043.0
Bahia;Área 044;37029;37029;37029;0;0;2927408005044.0
Bahia;Área 045;88151;87595;87429;166;556;2927408005045.0
Bahia;Área 046;69928;69909;69909;0;19;2927408005046.0
Bahia;Área 047;25473;25299;25126;173;174;2927408005047.0
Bahia;Área 048;47763;47763;47763;0;0;2927408005048.0
Bahia;Área 049;51475;51441;51441;0;34;2927408005049.0
Bahia;Área 050;51873;51873;51873;0;0;2927408005050.0
Bahia;Área 051;27041;27041;27041;0;0;2927408005051.0
Bahia;Área 052;25234;25184;25168;15;50;2927408005052.0
Bahia;Área 053;54339;54339;54339;0;0;2927408005053.0
Bahia;Área 054;25472;25455;25455;0;17;2927408005054.0
Bahia;Área 055;26602;26602;26602;0;0;2927408005055.0
Bahia;Área 056;32302;32258;32258;0;44;2927408005056.0
Bahia;Área 057;27205;27205;27205;0;0;2927408005057.0
Bahia;Área 058;34792;34792;34772;20;0;2927408005058.0
Bahia;Área 059;29913;29511;29466;45;402;2927408005059.0
Bahia;Área 060;39998;39887;39812;75;111;2927408005060.0
Bahia;Área 061;31807;31807;31807;0;0;2927408005061.0
Bahia;Área 062;49639;49591;49572;19;48;2927408005062.0
Bahia;Santa Maria da Vitória;40309;40296;40287;8;13;2928109.0
Bahia;Área 001;15256;15243;15234;8;13;2928109003001.0
Bahia;Área 002;25053;25053;25053;0;0;2928109003002.0
Bahia;Santaluz;33838;33838;33838;0;0;2928000.0
Bahia;Área 001;15297;15297;15297;0;0;2928000003001.0
Bahia;Área 002;18541;18541;18541;0;0;2928000003002.0
Bahia;Santo Amaro;57800;57790;57780;10;10;2928604.0
Bahia;Área 001;15973;15963;15963;0;10;2928604003001.0
Bahia;Área 002;16369;16369;16359;10;0;2928604003002.0
Bahia;Área 003;25458;25458;25458;0;0;2928604003003.0
Bahia;Santo Antônio de Jesus;90985;90962;90952;10;23;2928703.0
Bahia;Área 001;16707;16697;16697;0;10;2928703003001.0
Bahia;Área 002;14145;14145;14145;0;0;2928703003002.0
Bahia;Área 003;25327;25314;25305;10;13;2928703003003.0
Bahia;Área 004;34806;34806;34806;0;0;2928703003004.0
Bahia;Santo Estêvão;47880;47880;47880;0;0;2928802.0
Bahia;Área 001;21802;21802;21802;0;0;2928802003001.0
Bahia;Área 002;26078;26078;26078;0;0;2928802003002.0
Bahia;São Francisco do Conde;33183;33183;33183;0;0;2929206.0
Bahia;Área 001;15348;15348;15348;0;0;2929206003001.0
Bahia;Área 002;17835;17835;17835;0;0;2929206003002.0
Bahia;São Gonçalo dos Campos;33283;33283;33283;0;0;2929305.0
Bahia;Área 001;16299;16299;16299;0;0;2929305003001.0
Bahia;Área 002;16984;16984;16984;0;0;2929305003002.0
Bahia;São Sebastião do Passé;42153;42153;42140;13;0;2929503.0
Bahia;Área 001;16740;16740;16727;13;0;2929503003001.0
Bahia;Área 002;25413;25413;25413;0;0;2929503003002.0
Bahia;Seabra;41798;41798;41798;0;0;2929909.0
Bahia;Área 001;14147;14147;14147;0;0;2929909003001.0
Bahia;Área 002;27651;27651;27651;0;0;2929909003002.0
Bahia;Senhor do Bonfim;74419;74419;74419;0;0;2930105.0
Bahia;Área 001;13497;13497;13497;0;0;2930105003001.0
Bahia;Área 002;14369;14369;14369;0;0;2930105003002.0
Bahia;Área 003;22255;22255;22255;0;0;2930105003003.0
Bahia;Área 004;24298;24298;24298;0;0;2930105003004.0
Bahia;Serrinha;76762;76741;76716;26;21;2930501.0
Bahia;Área 001;15814;15814;15814;0;0;2930501003001.0
Bahia;Área 002;15658;15651;15651;0;7;2930501003002.0
Bahia;Área 003;22220;22220;22206;14;0;2930501003003.0
Bahia;Área 004;23070;23056;23044;12;14;2930501003004.0
Bahia;Simões Filho;118047;117995;117995;0;52;2930709.0
Bahia;Área 001;15106;15106;15106;0;0;2930709003001.0
Bahia;Área 002;18081;18081;18081;0;0;2930709003002.0
Bahia;Área 003;17772;17772;17772;0;0;2930709003003.0
Bahia;Área 004;19443;19401;19401;0;42;2930709003004.0
Bahia;Área 005;20327;20317;20317;0;10;2930709003005.0
Bahia;Área 006;27318;27318;27318;0;0;2930709003006.0
Bahia;Teixeira de Freitas;138341;138161;138039;122;180;2931350.0
Bahia;Área 001;14421;14421;14421;0;0;2931350003001.0
Bahia;Área 002;15517;15511;15511;0;6;2931350003002.0
Bahia;Área 003;31471;31462;31414;48;9;2931350003003.0
Bahia;Área 004;15426;15404;15388;17;22;2931350003004.0
Bahia;Área 005;24687;24633;24587;46;54;2931350003005.0
Bahia;Área 006;36819;36730;36719;11;89;2931350003006.0
Bahia;Tucano;52418;52418;52411;7;0;2931905.0
Bahia;Área 001;25307;25307;25300;7;0;2931905003001.0
Bahia;Área 002;27111;27111;27111;0;0;2931905003002.0
Bahia;Valença;88673;88608;88583;25;65;2932903.0
Bahia;Área 001;12647;12637;12630;7;10;2932903003001.0
Bahia;Área 002;13340;13324;13324;0;16;2932903003002.0
Bahia;Área 003;14660;14660;14660;0;0;2932903003003.0
Bahia;Área 004;22551;22541;22532;9;10;2932903003004.0
Bahia;Área 005;25475;25446;25437;9;29;2932903003005.0
Bahia;Vera Cruz;37567;37465;37451;15;102;2933208.0
Bahia;Área 001;15642;15607;15607;0;35;2933208003001.0
Bahia;Área 002;21925;21859;21844;15;66;2933208003002.0
Bahia;Vitória da Conquista;306866;306781;306731;50;85;2933307.0
Bahia;33307-Área 01;17826;17803;17788;15;23;2933307005001.0
Bahia;33307-Área 02;29298;29298;29298;0;0;2933307005002.0
Bahia;33307-Área 03;22896;22888;22888;0;8;2933307005003.0
Bahia;33307-Área 04;21310;21295;21295;0;15;2933307005004.0
Bahia;33307-Área 05;27132;27111;27111;0;21;2933307005005.0
Bahia;33307-Área 06;18346;18346;18336;10;0;2933307005006.0
Bahia;33307-Área 07;20892;20892;20892;0;0;2933307005007.0
Bahia;33307-Área 08;19992;19974;19960;14;18;2933307005008.0
Bahia;33307-Área 09;26144;26144;26144;0;0;2933307005009.0
Bahia;33307-Área 10;27097;27097;27086;11;0;2933307005010.0
Bahia;33307-Área 11;29327;29327;29327;0;0;2933307005011.0
Bahia;33307-Área 12;15872;15872;15872;0;0;2933307005012.0
Bahia;33307-Área 13;14916;14916;14916;0;0;2933307005013.0
Bahia;33307-Área 14;15818;15818;15818;0;0;2933307005014.0
Bahia;Xique-Xique;45536;45536;45536;0;0;2933604.0
Bahia;Área 001;16754;16754;16754;0;0;2933604003001.0
Bahia;Área 002;28782;28782;28782;0;0;2933604003002.0
Minas Gerais;Além Paraíba;34349;34349;34339;10;0;3101508.0
Minas Gerais;Área 001;13205;13205;13205;0;0;3101508003001.0
Minas Gerais;Área 002;21144;21144;21134;10;0;3101508003002.0
Minas Gerais;Alfenas;73774;73735;73727;8;39;3101607.0
Minas Gerais;Área 001;13265;13256;13256;0;9;3101607003001.0
Minas Gerais;Área 002;29656;29626;29626;0;30;3101607003002.0
Minas Gerais;Área 003;30853;30853;30845;8;0;3101607003003.0
Minas Gerais;Almenara;38775;38767;38767;0;8;3101706.0
Minas Gerais;Área 001;13653;13653;13653;0;0;3101706003001.0
Minas Gerais;Área 002;25122;25114;25114;0;8;3101706003002.0
Minas Gerais;Andradas;37270;37243;37233;10;27;3102605.0
Minas Gerais;Área 001;11880;11864;11854;10;16;3102605003001.0
Minas Gerais;Área 002;25390;25380;25380;0;10;3102605003002.0
Minas Gerais;Araçuaí;36013;36002;35992;11;11;3103405.0
Minas Gerais;Área 001;15150;15150;15150;0;0;3103405003001.0
Minas Gerais;Área 002;20863;20852;20842;11;11;3103405003002.0
Minas Gerais;Araguari;109801;109682;109662;20;119;3103504.0
Minas Gerais;Área 001;15580;15542;15542;0;38;3103504003001.0
Minas Gerais;Área 002;13706;13706;13706;0;0;3103504003002.0
Minas Gerais;Área 003;22111;22101;22092;8;10;3103504003003.0
Minas Gerais;Área 004;13492;13492;13492;0;0;3103504003004.0
Minas Gerais;Área 005;23492;23471;23471;0;21;3103504003005.0
Minas Gerais;Área 006;21420;21370;21359;11;50;3103504003006.0
Minas Gerais;Araxá;93672;93607;93531;75;65;3104007.0
Minas Gerais;Área 001;13805;13805;13805;0;0;3104007003001.0
Minas Gerais;Área 002;14078;14078;14066;12;0;3104007003002.0
Minas Gerais;Área 003;14358;14330;14327;3;28;3104007003003.0
Minas Gerais;Área 004;21926;21904;21853;51;22;3104007003004.0
Minas Gerais;Área 005;29505;29490;29481;9;15;3104007003005.0
Minas Gerais;Arcos;36597;36597;36580;17;0;3104205.0
Minas Gerais;Área 001;15624;15624;15607;17;0;3104205003001.0
Minas Gerais;Área 002;20973;20973;20973;0;0;3104205003002.0
Minas Gerais;Barbacena;126284;126228;126190;38;56;3105608.0
Minas Gerais;Área 001;14254;14244;14244;0;10;3105608003001.0
Minas Gerais;Área 002;14880;14880;14880;0;0;3105608003002.0
Minas Gerais;Área 003;14066;14066;14066;0;0;3105608003003.0
Minas Gerais;Área 004;14176;14176;14176;0;0;3105608003004.0
Minas Gerais;Área 005;14122;14098;14098;0;24;3105608003005.0
Minas Gerais;Área 006;25394;25394;25394;0;0;3105608003006.0
Minas Gerais;Área 007;29392;29369;29331;38;23;3105608003007.0
Minas Gerais;Belo Horizonte;2375151;2369063;2367032;2030;6088;3106200.0
Minas Gerais;B1;45869;45849;45849;0;20;3106200005001.0
Minas Gerais;B2;42531;42475;42475;0;56;3106200005002.0
Minas Gerais;B3;52370;52352;52352;0;18;3106200005003.0
Minas Gerais;B4-A;29647;29647;29647;0;0;3106200005004.0
Minas Gerais;B4-B;38371;38360;38345;15;11;3106200005005.0
Minas Gerais;B5-A;29669;29669;29641;28;0;3106200005006.0
Minas Gerais;B5-B;44095;44095;44095;0;0;3106200005007.0
Minas Gerais;Cs1 – A;30981;30606;30324;282;375;3106200005008.0
Minas Gerais;Cs1 – B;28786;28100;28049;51;686;3106200005009.0
Minas Gerais;Cs1 – C;25174;24958;24875;83;216;3106200005010.0
Minas Gerais;Cs2 – A;27329;27102;27043;59;227;3106200005011.0
Minas Gerais;Cs2 – B;34795;34158;34010;148;637;3106200005012.0
Minas Gerais;Cs2 – C;23576;23322;23322;0;254;3106200005013.0
Minas Gerais;Cs3;38405;38405;38405;0;0;3106200005014.0
Minas Gerais;Cs4 – A;43642;43390;43216;174;252;3106200005015.0
Minas Gerais;Cs4 – B;31088;30938;30878;60;150;3106200005016.0
Minas Gerais;L1;61084;61019;61019;0;65;3106200005017.0
Minas Gerais;L2-A;40366;40347;40294;53;19;3106200005018.0
Minas Gerais;L2-B;37065;36821;36730;91;244;3106200005019.0
Minas Gerais;L3-A;28331;28285;28268;17;46;3106200005020.0
Minas Gerais;L3-B;27739;27686;27686;0;53;3106200005021.0
Minas Gerais;L4;43954;43954;43954;0;0;3106200005022.0
Minas Gerais;N1;34892;34892;34892;0;0;3106200005023.0
Minas Gerais;N2-A;36709;36709;36709;0;0;3106200005024.0
Minas Gerais;N2-B;29622;29622;29604;18;0;3106200005025.0
Minas Gerais;N3-A;48355;48355;48331;24;0;3106200005026.0
Minas Gerais;N3-B;26668;26475;26409;66;193;3106200005027.0
Minas Gerais;N4;35809;35789;35754;35;20;3106200005028.0
Minas Gerais;Ne1-A;28324;28311;28311;0;13;3106200005029.0
Minas Gerais;Ne1-B;50161;50161;50161;0;0;3106200005030.0
Minas Gerais;Ne2;40573;40573;40573;0;0;3106200005031.0
Minas Gerais;Ne3;43425;43414;43414;0;11;3106200005032.0
Minas Gerais;Ne4-A;27734;27684;27664;20;50;3106200005033.0
Minas Gerais;Ne4-B;36068;35963;35963;0;105;3106200005034.0
Minas Gerais;Ne5-A;31078;30936;30883;53;142;3106200005035.0
Minas Gerais;Ne5-B;32990;32936;32902;34;54;3106200005036.0
Minas Gerais;No1-A;32620;32620;32620;0;0;3106200005037.0
Minas Gerais;No1-B;27874;27811;27811;0;63;3106200005038.0
Minas Gerais;No2;41801;41801;41779;22;0;3106200005039.0
Minas Gerais;No3-A;32625;32625;32625;0;0;3106200005040.0
Minas Gerais;No3-B;26780;26780;26780;0;0;3106200005041.0
Minas Gerais;No3-C;28322;28268;28268;0;54;3106200005042.0
Minas Gerais;No4-A;46280;46217;46173;43;63;3106200005043.0
Minas Gerais;No4-B;31736;31685;31643;42;51;3106200005044.0
Minas Gerais;O1-A;29897;29876;29876;0;21;3106200005045.0
Minas Gerais;O1-B;30730;30679;30668;12;51;3106200005046.0
Minas Gerais;O1-C;29765;29512;29390;122;253;3106200005047.0
Minas Gerais;O1-D;32358;32358;32336;22;0;3106200005048.0
Minas Gerais;O2-A;30163;30101;30081;20;62;3106200005049.0
Minas Gerais;O2-B;26805;26775;26775;0;30;3106200005050.0
Minas Gerais;O2-C;34640;34640;34640;0;0;3106200005051.0
Minas Gerais;O4-A;28722;28702;28702;0;20;3106200005052.0
Minas Gerais;O4-B;30827;30756;30756;0;71;3106200005053.0
Minas Gerais;O5;34642;34463;34414;49;179;3106200005054.0
Minas Gerais;P1;48050;47779;47662;117;271;3106200005055.0
Minas Gerais;P2-A;24868;24755;24715;41;113;3106200005056.0
Minas Gerais;P2-B;31107;30840;30705;136;267;3106200005057.0
Minas Gerais;P3;41226;40866;40817;50;360;3106200005058.0
Minas Gerais;P4-A;31442;31419;31419;0;23;3106200005059.0
Minas Gerais;P4-B;49417;49323;49323;0;94;3106200005060.0
Minas Gerais;Vn1;47160;47143;47143;0;17;3106200005061.0
Minas Gerais;Vn2;50356;50311;50311;0;45;3106200005062.0
Minas Gerais;Vn3-A;44217;44180;44160;19;37;3106200005063.0
Minas Gerais;Vn3-B;27978;27978;27978;0;0;3106200005064.0
Minas Gerais;Vn4-A;29948;29948;29948;0;0;3106200005065.0
Minas Gerais;Vn4-B;32579;32579;32579;0;0;3106200005066.0
Minas Gerais;Vn4-C;32941;32916;32892;24;25;3106200005067.0
Minas Gerais;Betim;378089;377903;377769;133;186;3106705.0
Minas Gerais;Bandeirinha;14102;14086;14086;0;16;3106705005004.0
Minas Gerais;Bom Retiro;22355;22330;22320;10;25;3106705005009.0
Minas Gerais;Campos Eliseos;13872;13846;13846;0;26;3106705005006.0
Minas Gerais;Centro;28769;28747;28694;54;22;3106705005002.0
Minas Gerais;Citrolandia;22252;22244;22244;0;8;3106705005007.0
Minas Gerais;Dom Bosco;20735;20726;20726;0;9;3106705005014.0
Minas Gerais;Imbirucu;20351;20351;20351;0;0;3106705005018.0
Minas Gerais;Jardim das Alte;19538;19538;19538;0;0;3106705005013.0
Minas Gerais;Jardim Terezopo;23320;23300;23300;0;20;3106705005019.0
Minas Gerais;Laranjeiras;13343;13330;13330;0;13;3106705005016.0
Minas Gerais;Niteroi;16143;16132;16132;0;11;3106705005011.0
Minas Gerais;Novo Horizonte;19811;19787;19757;30;24;3106705005008.0
Minas Gerais;Parque das Indu;15836;15836;15817;19;0;3106705005010.0
Minas Gerais;Paulo Camilo;14109;14109;14109;0;0;3106705005005.0
Minas Gerais;Santo Antônio;17000;17000;17000;0;0;3106705005020.0
Minas Gerais;São Caetano;21239;21239;21239;0;0;3106705005017.0
Minas Gerais;São Joao;20939;20939;20931;8;0;3106705005003.0
Minas Gerais;Várzea das Flor;22779;22779;22779;0;0;3106705005012.0
Minas Gerais;Vianópolis;15238;15225;15213;12;13;3106705005001.0
Minas Gerais;Vila Cristina;16358;16358;16358;0;0;3106705005015.0
Minas Gerais;Boa Esperança;38516;38506;38488;18;10;3107109.0
Minas Gerais;Área 001;15122;15122;15122;0;0;3107109003001.0
Minas Gerais;Área 002;23394;23384;23366;18;10;3107109003002.0
Minas Gerais;Bocaiúva;46654;46632;46616;16;22;3107307.0
Minas Gerais;Área 001;23155;23133;23117;16;22;3107307003001.0
Minas Gerais;Área 002;23499;23499;23499;0;0;3107307003002.0
Minas Gerais;Bom Despacho;45624;45586;45578;9;38;3107406.0
Minas Gerais;Área 001;20158;20158;20149;9;0;3107406003001.0
Minas Gerais;Área 002;25466;25428;25428;0;38;3107406003002.0
Minas Gerais;Brasília de Minas;31213;31213;31213;0;0;3108602.0
Minas Gerais;Área 001;16278;16278;16278;0;0;3108602003001.0
Minas Gerais;Área 002;14935;14935;14935;0;0;3108602003002.0
Minas Gerais;Brumadinho;33973;33889;33866;23;84;3109006.0
Minas Gerais;Área 001;16335;16326;16317;9;9;3109006003001.0
Minas Gerais;Área 002;17638;17563;17549;14;75;3109006003002.0
Minas Gerais;Caeté;40750;40750;40730;20;0;3110004.0
Minas Gerais;Área 001;17348;17348;17337;11;0;3110004003001.0
Minas Gerais;Área 002;23402;23402;23394;8;0;3110004003002.0
Minas Gerais;Cambuí;26488;26450;26440;10;38;3110608.0
Minas Gerais;Área 001;12926;12926;12926;0;0;3110608003001.0
Minas Gerais;Área 002;13562;13524;13514;10;38;3110608003002.0
Minas Gerais;Campo Belo;51544;51544;51544;0;0;3111200.0
Minas Gerais;Área 001;12179;12179;12179;0;0;3111200003001.0
Minas Gerais;Área 002;17212;17212;17212;0;0;3111200003002.0
Minas Gerais;Área 003;22153;22153;22153;0;0;3111200003003.0
Minas Gerais;Capelinha;34803;34793;34780;13;10;3112307.0
Minas Gerais;Área 001;14806;14796;14796;0;10;3112307003001.0
Minas Gerais;Área 002;19997;19997;19984;13;0;3112307003002.0
Minas Gerais;Carangola;32296;32296;32296;0;0;3113305.0
Minas Gerais;Área 001;12335;12335;12335;0;0;3113305003001.0
Minas Gerais;Área 002;19961;19961;19961;0;0;3113305003002.0
Minas Gerais;Caratinga;85239;85199;85177;22;40;3113404.0
Minas Gerais;Área 001;13425;13425;13425;0;0;3113404003001.0
Minas Gerais;Área 002;13445;13416;13416;0;29;3113404003002.0
Minas Gerais;Área 003;25356;25344;25323;22;12;3113404003003.0
Minas Gerais;Área 004;33013;33013;33013;0;0;3113404003004.0
Minas Gerais;Carmo do Paranaíba;29735;29669;29635;34;66;3114303.0
Minas Gerais;Área 001;12429;12405;12399;6;24;3114303003001.0
Minas Gerais;Área 002;17306;17263;17236;28;43;3114303003002.0
Minas Gerais;Cataguases;69757;69722;69722;0;35;3115300.0
Minas Gerais;Área 001;14902;14902;14902;0;0;3115300003001.0
Minas Gerais;Área 002;14389;14389;14389;0;0;3115300003002.0
Minas Gerais;Área 003;20129;20129;20129;0;0;3115300003003.0
Minas Gerais;Área 004;20337;20302;20302;0;35;3115300003004.0
Minas Gerais;Congonhas;48519;48519;48508;11;0;3118007.0
Minas Gerais;Área 001;19073;19073;19073;0;0;3118007003001.0
Minas Gerais;Área 002;29446;29446;29435;11;0;3118007003002.0
Minas Gerais;Conselheiro Lafaiete;116512;116460;116397;63;52;3118304.0
Minas Gerais;Área 001;15425;15413;15413;0;12;3118304003001.0
Minas Gerais;Área 002;22975;22975;22975;0;0;3118304003002.0
Minas Gerais;Área 003;19206;19206;19183;23;0;3118304003003.0
Minas Gerais;Área 004;25379;25379;25379;0;0;3118304003004.0
Minas Gerais;Área 005;33527;33487;33447;40;40;3118304003005.0
Minas Gerais;Contagem;603442;603053;602911;143;389;3118601.0
Minas Gerais;Água Branca;41887;41841;41841;0;46;3118601005008.0
Minas Gerais;Ceasa;35400;35400;35400;0;0;3118601005007.0
Minas Gerais;Eldorado Leste;35247;35228;35228;0;19;3118601005009.0
Minas Gerais;Eldorado Oeste;37709;37667;37667;0;42;3118601005014.0
Minas Gerais;Inconfidente;32654;32579;32579;0;75;3118601005011.0
Minas Gerais;Industrial;58230;58230;58230;0;0;3118601005010.0
Minas Gerais;Laguna;30969;30969;30918;51;0;3118601005006.0
Minas Gerais;Nacional;61432;61349;61349;0;83;3118601005004.0
Minas Gerais;Petrolândia;38604;38604;38604;0;0;3118601005002.0
Minas Gerais;Riacho;58424;58379;58379;0;45;3118601005012.0
Minas Gerais;São Joaquim;28894;28871;28829;42;23;3118601005005.0
Minas Gerais;Sede Norte;47795;47769;47769;0;26;3118601005003.0
Minas Gerais;Sede Sul;40959;40930;40904;27;29;3118601005013.0
Minas Gerais;Vargem das F;55238;55238;55215;23;0;3118601005001.0
Minas Gerais;Coromandel;27547;27547;27547;0;0;3119302.0
Minas Gerais;Área 001;11779;11779;11779;0;0;3119302003001.0
Minas Gerais;Área 002;15768;15768;15768;0;0;3119302003002.0
Minas Gerais;Coronel Fabriciano;103694;103616;103584;32;78;3119401.0
Minas Gerais;Área 001;18286;18271;18258;13;15;3119401003001.0
Minas Gerais;Área 002;24412;24386;24376;10;26;3119401003002.0
Minas Gerais;Área 003;14219;14207;14207;0;12;3119401003003.0
Minas Gerais;Área 004;22184;22184;22184;0;0;3119401003004.0
Minas Gerais;Área 005;24593;24569;24560;9;24;3119401003005.0
Minas Gerais;Curvelo;74219;74219;74207;12;0;3120904.0
Minas Gerais;Área 001;15629;15629;15629;0;0;3120904003001.0
Minas Gerais;Área 002;26903;26903;26903;0;0;3120904003002.0
Minas Gerais;Área 003;31687;31687;31675;12;0;3120904003003.0
Minas Gerais;Diamantina;45880;45880;45854;26;0;3121605.0
Minas Gerais;Área 001;19685;19685;19674;11;0;3121605003001.0
Minas Gerais;Área 002;26195;26195;26180;15;0;3121605003002.0
Minas Gerais;Divinópolis;213016;212907;212827;80;109;3122306.0
Minas Gerais;Região Bom Pastor-Candelária;25476;25466;25456;11;10;3122306005002.0
Minas Gerais;Região Central-Esplanada;39382;39339;39316;23;43;3122306005001.0
Minas Gerais;Região Nitéroi-Icaraí;34904;34904;34887;17;0;3122306005003.0
Minas Gerais;Região Porto Velho-Nações;46171;46164;46154;11;7;3122306005004.0
Minas Gerais;Região Rural-Periurbana;15161;15161;15161;0;0;3122306005007.0
Minas Gerais;Região Santo Antônio dos Campos-Tiête;16830;16820;16820;0;10;3122306005006.0
Minas Gerais;Região São José-Belvedere;35092;35053;35033;20;39;3122306005005.0
Minas Gerais;Esmeraldas;60271;60250;60230;20;21;3124104.0
Minas Gerais;Área 001;28242;28230;28230;0;12;3124104003001.0
Minas Gerais;Área 002;32029;32020;32000;20;9;3124104003002.0
Minas Gerais;Espinosa;31113;31113;31113;0;0;3124302.0
Minas Gerais;Área 001;14907;14907;14907;0;0;3124302003001.0
Minas Gerais;Área 002;16206;16206;16206;0;0;3124302003002.0
Minas Gerais;Formiga;65128;65094;65087;7;34;3126109.0
Minas Gerais;Área 001;15441;15441;15441;0;0;3126109003001.0
Minas Gerais;Área 002;24218;24206;24199;7;12;3126109003002.0
Minas Gerais;Área 003;25469;25447;25447;0;22;3126109003003.0
Minas Gerais;Frutal;53468;53425;53372;53;43;3127107.0
Minas Gerais;Área 001;21430;21401;21357;44;29;3127107003001.0
Minas Gerais;Área 002;32038;32024;32015;9;14;3127107003002.0
Minas Gerais;Governador Valadares;263689;263006;262569;438;683;3127701.0
Minas Gerais;Área 001;19405;19398;19337;60;7;3127701005001.0
Minas Gerais;Área 002;21670;21597;21582;15;73;3127701005002.0
Minas Gerais;Área 003;22655;22635;22624;11;20;3127701005003.0
Minas Gerais;Área 004;19860;19850;19850;0;10;3127701005004.0
Minas Gerais;Área 005;17424;17329;17299;30;95;3127701005005.0
Minas Gerais;Área 006;22238;22210;22167;43;28;3127701005006.0
Minas Gerais;Área 007;15703;15684;15651;32;19;3127701005007.0
Minas Gerais;Área 008;20946;20887;20887;0;59;3127701005008.0
Minas Gerais;Área 009;15117;15072;15027;45;45;3127701005009.0
Minas Gerais;Área 010;27827;27606;27491;116;221;3127701005010.0
Minas Gerais;Área 011;19248;19238;19205;33;10;3127701005011.0
Minas Gerais;Área 012;23584;23570;23532;38;14;3127701005012.0
Minas Gerais;Área 013;18012;17931;17916;15;81;3127701005013.0
Minas Gerais;Guanhães;31262;31253;31200;53;9;3128006.0
Minas Gerais;Área 001;13765;13756;13735;21;9;3128006003001.0
Minas Gerais;Área 002;17497;17497;17465;32;0;3128006003002.0
Minas Gerais;Guaxupé;49430;49378;49369;9;52;3128709.0
Minas Gerais;Área 001;25210;25176;25167;9;34;3128709003001.0
Minas Gerais;Área 002;24220;24202;24202;0;18;3128709003002.0
Minas Gerais;Ibirité;158954;158935;158891;45;19;3129806.0
Minas Gerais;Área 001;15366;15366;15357;9;0;3129806003001.0
Minas Gerais;Área 002;14608;14608;14608;0;0;3129806003002.0
Minas Gerais;Área 003;18031;18031;18031;0;0;3129806003003.0
Minas Gerais;Área 004;18539;18539;18539;0;0;3129806003004.0
Minas Gerais;Área 005;28430;28411;28386;26;19;3129806003005.0
Minas Gerais;Área 006;16372;16372;16372;0;0;3129806003006.0
Minas Gerais;Área 007;15421;15421;15421;0;0;3129806003007.0
Minas Gerais;Área 008;32187;32187;32177;10;0;3129806003008.0
Minas Gerais;Igarapé;34851;34851;34837;14;0;3130101.0
Minas Gerais;Área 001;14532;14532;14518;14;0;3130101003001.0
Minas Gerais;Área 002;20319;20319;20319;0;0;3130101003002.0
Minas Gerais;Ipatinga;239468;239197;238980;217;271;3131307.0
Minas Gerais;Área 001;19265;19231;19185;46;34;3131307005001.0
Minas Gerais;Área 002;19460;19439;19439;0;21;3131307005002.0
Minas Gerais;Área 003;24236;24200;24140;59;36;3131307005003.0
Minas Gerais;Área 004;25426;25400;25384;16;26;3131307005004.0
Minas Gerais;Área 005;19191;19143;19143;0;48;3131307005005.0
Minas Gerais;Área 006;17833;17833;17833;0;0;3131307005006.0
Minas Gerais;Área 007;23276;23276;23255;21;0;3131307005007.0
Minas Gerais;Área 008;21487;21441;21410;31;46;3131307005008.0
Minas Gerais;Área 009;15198;15164;15164;0;34;3131307005009.0
Minas Gerais;Área 010;16667;16653;16644;9;14;3131307005010.0
Minas Gerais;Área 011;18171;18171;18171;0;0;3131307005011.0
Minas Gerais;Área 012;19258;19246;19212;34;12;3131307005012.0
Minas Gerais;Itabira;109783;109734;109734;0;49;3131703.0
Minas Gerais;Área 001;16749;16738;16738;0;11;3131703003001.0
Minas Gerais;Área 002;23020;23020;23020;0;0;3131703003002.0
Minas Gerais;Área 003;18673;18673;18673;0;0;3131703003003.0
Minas Gerais;Área 004;25377;25339;25339;0;38;3131703003004.0
Minas Gerais;Área 005;25964;25964;25964;0;0;3131703003005.0
Minas Gerais;Itabirito;45449;45449;45449;0;0;3131901.0
Minas Gerais;Área 001;21410;21410;21410;0;0;3131901003001.0
Minas Gerais;Área 002;24039;24039;24039;0;0;3131901003002.0
Minas Gerais;Itajubá;90658;90478;90331;148;180;3132404.0
Minas Gerais;Área 001;14547;14547;14547;0;0;3132404003001.0
Minas Gerais;Área 002;33144;33103;33091;12;41;3132404003002.0
Minas Gerais;Área 003;20482;20451;20451;0;31;3132404003003.0
Minas Gerais;Área 004;22485;22378;22241;136;107;3132404003004.0
Minas Gerais;Itamarandiba;32175;32162;32156;6;13;3132503.0
Minas Gerais;Área 001;15525;15525;15525;0;0;3132503003001.0
Minas Gerais;Área 002;16650;16637;16631;6;13;3132503003002.0
Minas Gerais;Itaúna;85463;85411;85411;0;52;3133808.0
Minas Gerais;Área 001;13766;13755;13755;0;11;3133808003001.0
Minas Gerais;Área 002;24030;24017;24017;0;13;3133808003002.0
Minas Gerais;Área 003;21847;21837;21837;0;10;3133808003003.0
Minas Gerais;Área 004;25820;25803;25803;0;17;3133808003004.0
Minas Gerais;Ituiutaba;97171;97096;97062;33;75;3134202.0
Minas Gerais;Área 001;12123;12123;12112;11;0;3134202003001.0
Minas Gerais;Área 002;20245;20245;20232;13;0;3134202003002.0
Minas Gerais;Área 003;13781;13771;13771;0;10;3134202003003.0
Minas Gerais;Área 004;15196;15196;15196;0;0;3134202003004.0
Minas Gerais;Área 005;15852;15787;15777;9;65;3134202003005.0
Minas Gerais;Área 006;19974;19974;19974;0;0;3134202003006.0
Minas Gerais;Iturama;34456;34456;34441;15;0;3134400.0
Minas Gerais;Área 001;13974;13974;13959;15;0;3134400003001.0
Minas Gerais;Área 002;20482;20482;20482;0;0;3134400003002.0
Minas Gerais;Jaíba;33587;33587;33587;0;0;3135050.0
Minas Gerais;Área 001;16711;16711;16711;0;0;3135050003001.0
Minas Gerais;Área 002;16876;16876;16876;0;0;3135050003002.0
Minas Gerais;Janaúba;66803;66793;66793;0;10;3135100.0
Minas Gerais;Área 001;22034;22034;22034;0;0;3135100003001.0
Minas Gerais;Área 002;22558;22558;22558;0;0;3135100003002.0
Minas Gerais;Área 003;22211;22201;22201;0;10;3135100003003.0
Minas Gerais;Januária;65463;65463;65453;10;0;3135209.0
Minas Gerais;Área 001;26379;26379;26369;10;0;3135209003001.0
Minas Gerais;Área 002;39084;39084;39084;0;0;3135209003002.0
Minas Gerais;João Monlevade;73610;73605;73571;33;5;3136207.0
Minas Gerais;Área 001;16930;16925;16910;14;5;3136207003001.0
Minas Gerais;Área 002;26461;26461;26442;19;0;3136207003002.0
Minas Gerais;Área 003;30219;30219;30219;0;0;3136207003003.0
Minas Gerais;João Pinheiro;45260;45260;45260;0;0;3136306.0
Minas Gerais;Área 001;21187;21187;21187;0;0;3136306003001.0
Minas Gerais;Área 002;24073;24073;24073;0;0;3136306003002.0
Minas Gerais;Juiz de Fora;516247;515197;515011;186;1050;3136702.0
Minas Gerais;Área 001;51943;51891;51891;0;52;3136702005001.0
Minas Gerais;Área 002;35026;34971;34971;0;55;3136702005002.0
Minas Gerais;Área 003;35374;35344;35327;17;30;3136702005003.0
Minas Gerais;Área 004;51116;51093;51093;0;23;3136702005004.0
Minas Gerais;Área 005;24205;24071;24071;0;134;3136702005005.0
Minas Gerais;Área 006;27221;26923;26876;47;298;3136702005006.0
Minas Gerais;Área 007;44804;44636;44614;22;168;3136702005007.0
Minas Gerais;Área 008;34589;34589;34566;23;0;3136702005008.0
Minas Gerais;Área 009;26707;26689;26689;0;18;3136702005009.0
Minas Gerais;Área 010;45789;45696;45677;19;93;3136702005010.0
Minas Gerais;Área 011;29051;29004;29004;0;47;3136702005011.0
Minas Gerais;Área 012;28592;28592;28592;0;0;3136702005012.0
Minas Gerais;Área 013;42299;42215;42189;26;84;3136702005013.0
Minas Gerais;Área 014;39531;39483;39450;33;48;3136702005014.0
Minas Gerais;Lagoa da Prata;45984;45977;45970;7;7;3137205.0
Minas Gerais;Área 001;23167;23167;23167;0;0;3137205003001.0
Minas Gerais;Área 002;22817;22810;22803;7;7;3137205003002.0
Minas Gerais;Lagoa Santa;52520;52429;52388;41;91;3137601.0
Minas Gerais;Área 001;25665;25647;25638;9;18;3137601003001.0
Minas Gerais;Área 002;26855;26782;26750;32;73;3137601003002.0
Minas Gerais;Lavras;92200;92053;91947;106;147;3138203.0
Minas Gerais;Área 001;13441;13430;13430;0;11;3138203003001.0
Minas Gerais;Área 002;13481;13438;13438;0;43;3138203003002.0
Minas Gerais;Área 003;13878;13867;13845;22;11;3138203003003.0
Minas Gerais;Área 004;19676;19676;19656;20;0;3138203003004.0
Minas Gerais;Área 005;31724;31643;31578;64;81;3138203003005.0
Minas Gerais;Leopoldina;51130;51090;51090;0;40;3138401.0
Minas Gerais;Área 001;24402;24362;24362;0;40;3138401003001.0
Minas Gerais;Área 002;26728;26728;26728;0;0;3138401003002.0
Minas Gerais;Machado;38688;38688;38678;10;0;3139003.0
Minas Gerais;Área 001;14052;14052;14052;0;0;3139003003001.0
Minas Gerais;Área 002;24636;24636;24626;10;0;3139003003002.0
Minas Gerais;Manhuaçu;79574;79564;79547;17;10;3139409.0
Minas Gerais;Área 001;18403;18393;18393;0;10;3139409003001.0
Minas Gerais;Área 002;27335;27335;27335;0;0;3139409003002.0
Minas Gerais;Área 003;33836;33836;33819;17;0;3139409003003.0
Minas Gerais;Mantena;27111;27083;27052;32;28;3139607.0
Minas Gerais;Área 001;12270;12249;12227;22;21;3139607003001.0
Minas Gerais;Área 002;14841;14835;14825;10;6;3139607003002.0
Minas Gerais;Mariana;54219;54219;54208;11;0;3140001.0
Minas Gerais;Área 001;19526;19526;19526;0;0;3140001003001.0
Minas Gerais;Área 002;34693;34693;34682;11;0;3140001003002.0
Minas Gerais;Mateus Leme;27856;27827;27807;20;29;3140704.0
Minas Gerais;Área 001;13689;13685;13672;13;4;3140704003001.0
Minas Gerais;Área 002;14167;14142;14135;7;25;3140704003002.0
Minas Gerais;Monte Carmelo;45772;45750;45740;10;22;3143104.0
Minas Gerais;Área 001;19058;19036;19026;10;22;3143104003001.0
Minas Gerais;Área 002;26714;26714;26714;0;0;3143104003002.0
Minas Gerais;Montes Claros;361915;361711;361623;88;204;3143302.0
Minas Gerais;Carmelo;15692;15692;15692;0;0;3143302005016.0
Minas Gerais;Centro;14763;14729;14729;0;34;3143302005001.0
Minas Gerais;Cidade Industrial;17154;17146;17146;0;8;3143302005019.0
Minas Gerais;Cidade Nova;16801;16792;16782;10;9;3143302005008.0
Minas Gerais;Cintra;14770;14757;14757;0;13;3143302005010.0
Minas Gerais;Delfim Magalhães;16811;16811;16811;0;0;3143302005014.0
Minas Gerais;Ibituruna;15977;15914;15904;10;63;3143302005005.0
Minas Gerais;Jardim Alvorada;20454;20454;20454;0;0;3143302005013.0
Minas Gerais;Jardim Eldorado;15788;15788;15788;0;0;3143302005021.0
Minas Gerais;Jardim Primavera;21978;21978;21978;0;0;3143302005018.0
Minas Gerais;Jardim São Luiz;15602;15592;15580;11;10;3143302005006.0
Minas Gerais;Lourdes;14754;14754;14754;0;0;3143302005015.0
Minas Gerais;Major Prates;14822;14822;14822;0;0;3143302005007.0
Minas Gerais;Maracanã;14691;14691;14691;0;0;3143302005012.0
Minas Gerais;Rural + Distritos;23534;23534;23534;0;0;3143302005022.0
Minas Gerais;Santa Rita;15522;15522;15510;12;0;3143302005009.0
Minas Gerais;Santos Reis;16202;16202;16202;0;0;3143302005020.0
Minas Gerais;São João;15240;15240;15231;9;0;3143302005003.0
Minas Gerais;São José;13526;13483;13483;0;43;3143302005002.0
Minas Gerais;São Judas Tadeu;17596;17596;17596;0;0;3143302005011.0
Minas Gerais;Todos Os Santos;14085;14062;14051;11;23;3143302005004.0
Minas Gerais;Vera Cruz;16153;16153;16128;25;0;3143302005017.0
Minas Gerais;Muriaé;100765;100757;100747;9;8;3143906.0
Minas Gerais;Área 001;13686;13686;13686;0;0;3143906003001.0
Minas Gerais;Área 002;13226;13226;13226;0;0;3143906003002.0
Minas Gerais;Área 003;18749;18749;18749;0;0;3143906003003.0
Minas Gerais;Área 004;26190;26182;26172;9;8;3143906003004.0
Minas Gerais;Área 005;28914;28914;28914;0;0;3143906003005.0
Minas Gerais;Mutum;26661;26627;26627;0;34;3144003.0
Minas Gerais;Área 001;12794;12773;12773;0;21;3144003003001.0
Minas Gerais;Área 002;13867;13854;13854;0;13;3144003003002.0
Minas Gerais;Nanuque;40834;40817;40817;0;17;3144300.0
Minas Gerais;Área 001;20197;20186;20186;0;11;3144300003001.0
Minas Gerais;Área 002;20637;20631;20631;0;6;3144300003002.0
Minas Gerais;Nova Lima;80998;80768;80710;58;230;3144805.0
Minas Gerais;Área 001;13473;13398;13373;25;75;3144805003001.0
Minas Gerais;Área 002;14558;14558;14548;10;0;3144805003002.0
Minas Gerais;Área 003;26529;26374;26351;22;155;3144805003003.0
Minas Gerais;Área 004;26438;26438;26438;0;0;3144805003004.0
Minas Gerais;Nova Serrana;73699;73689;73689;0;10;3145208.0
Minas Gerais;Área 001;13769;13769;13769;0;0;3145208003001.0
Minas Gerais;Área 002;14563;14563;14563;0;0;3145208003002.0
Minas Gerais;Área 003;17973;17963;17963;0;10;3145208003003.0
Minas Gerais;Área 004;27394;27394;27394;0;0;3145208003004.0
Minas Gerais;Oliveira;39466;39444;39432;12;22;3145604.0
Minas Gerais;Área 001;19065;19043;19031;12;22;3145604003001.0
Minas Gerais;Área 002;20401;20401;20401;0;0;3145604003002.0
Minas Gerais;Ouro Branco;35268;35258;35217;41;10;3145901.0
Minas Gerais;Área 001;14395;14385;14366;19;10;3145901003001.0
Minas Gerais;Área 002;20873;20873;20851;22;0;3145901003002.0
Minas Gerais;Ouro Fino;31568;31555;31555;0;13;3146008.0
Minas Gerais;Área 001;13471;13471;13471;0;0;3146008003001.0
Minas Gerais;Área 002;18097;18084;18084;0;13;3146008003002.0
Minas Gerais;Ouro Preto;70281;70192;70182;9;89;3146107.0
Minas Gerais;Área 001;33997;33908;33898;9;89;3146107003001.0
Minas Gerais;Área 002;36284;36284;36284;0;0;3146107003002.0
Minas Gerais;Pará de Minas;84215;84195;84170;24;20;3147105.0
Minas Gerais;Área 001;14707;14703;14703;0;4;3147105003001.0
Minas Gerais;Área 002;17076;17076;17076;0;0;3147105003002.0
Minas Gerais;Área 003;24017;24001;23977;24;16;3147105003003.0
Minas Gerais;Área 004;28415;28415;28415;0;0;3147105003004.0
Minas Gerais;Paracatu;84718;84626;84598;29;92;3147006.0
Minas Gerais;Área 001;17223;17177;17177;0;46;3147006003001.0
Minas Gerais;Área 002;16292;16279;16279;0;13;3147006003002.0
Minas Gerais;Área 003;23326;23314;23314;0;12;3147006003003.0
Minas Gerais;Área 004;27877;27856;27827;29;21;3147006003004.0
Minas Gerais;Passos;106290;106271;106260;11;19;3147907.0
Minas Gerais;Área 001;15383;15383;15383;0;0;3147907003001.0
Minas Gerais;Área 002;14237;14237;14237;0;0;3147907003002.0
Minas Gerais;Área 003;14736;14727;14727;0;9;3147907003003.0
Minas Gerais;Área 004;12933;12923;12923;0;10;3147907003004.0
Minas Gerais;Área 005;22523;22523;22512;11;0;3147907003005.0
Minas Gerais;Área 006;26478;26478;26478;0;0;3147907003006.0
Minas Gerais;Patos de Minas;138710;138648;138540;108;62;3148004.0
Minas Gerais;Área 001;16189;16189;16178;11;0;3148004003001.0
Minas Gerais;Área 002;12450;12450;12450;0;0;3148004003002.0
Minas Gerais;Área 003;14087;14087;14076;11;0;3148004003003.0
Minas Gerais;Área 004;12472;12472;12472;0;0;3148004003004.0
Minas Gerais;Área 005;13264;13255;13255;0;9;3148004003005.0
Minas Gerais;Área 006;13772;13762;13704;57;10;3148004003006.0
Minas Gerais;Área 007;14321;14312;14312;0;9;3148004003007.0
Minas Gerais;Área 008;16331;16321;16302;19;10;3148004003008.0
Minas Gerais;Área 009;25824;25800;25790;10;24;3148004003009.0
Minas Gerais;Patrocínio;82471;82439;82424;15;32;3148103.0
Minas Gerais;Área 001;14393;14393;14393;0;0;3148103003001.0
Minas Gerais;Área 002;15714;15714;15714;0;0;3148103003002.0
Minas Gerais;Área 003;25669;25659;25652;6;10;3148103003003.0
Minas Gerais;Área 004;26695;26673;26665;9;22;3148103003004.0
Minas Gerais;Pedro Leopoldo;58740;58726;58704;22;14;3149309.0
Minas Gerais;Área 001;14882;14882;14882;0;0;3149309003001.0
Minas Gerais;Área 002;19694;19694;19682;12;0;3149309003002.0
Minas Gerais;Área 003;24164;24150;24140;10;14;3149309003003.0
Minas Gerais;Pirapora;53368;53335;53335;0;33;3151206.0
Minas Gerais;Área 001;25678;25678;25678;0;0;3151206003001.0
Minas Gerais;Área 002;27690;27657;27657;0;33;3151206003002.0
Minas Gerais;Piumhi;31883;31839;31839;0;44;3151503.0
Minas Gerais;Área 001;11865;11865;11865;0;0;3151503003001.0
Minas Gerais;Área 002;20018;19974;19974;0;44;3151503003002.0
Minas Gerais;Poços de Caldas;152435;152093;151793;301;342;3151800.0
Minas Gerais;Área 001;12881;12839;12810;29;42;3151800003001.0
Minas Gerais;Área 002;13633;13622;13622;0;11;3151800003002.0
Minas Gerais;Área 003;12201;12159;12066;93;42;3151800003003.0
Minas Gerais;Área 004;11484;11461;11434;27;23;3151800003004.0
Minas Gerais;Área 005;22264;22220;22191;29;44;3151800003005.0
Minas Gerais;Área 006;13738;13684;13662;21;54;3151800003006.0
Minas Gerais;Área 007;15338;15338;15276;62;0;3151800003007.0
Minas Gerais;Área 008;20922;20922;20914;8;0;3151800003008.0
Minas Gerais;Área 009;29974;29849;29816;32;125;3151800003009.0
Minas Gerais;Ponte Nova;57390;57380;57371;9;10;3152105.0
Minas Gerais;Área 001;14270;14270;14270;0;0;3152105003001.0
Minas Gerais;Área 002;21648;21638;21638;0;10;3152105003002.0
Minas Gerais;Área 003;21472;21472;21463;9;0;3152105003003.0
Minas Gerais;Porteirinha;37627;37627;37627;0;0;3152204.0
Minas Gerais;Área 001;13980;13980;13980;0;0;3152204003001.0
Minas Gerais;Área 002;23647;23647;23647;0;0;3152204003002.0
Minas Gerais;Pouso Alegre;130615;130488;130385;103;127;3152501.0
Minas Gerais;Área 001;14261;14245;14245;0;16;3152501003001.0
Minas Gerais;Área 002;12630;12630;12585;45;0;3152501003002.0
Minas Gerais;Área 003;13567;13567;13567;0;0;3152501003003.0
Minas Gerais;Área 004;37332;37292;37272;20;40;3152501003004.0
Minas Gerais;Área 005;23089;23047;23047;0;42;3152501003005.0
Minas Gerais;Área 006;29736;29706;29668;38;30;3152501003006.0
Minas Gerais;Ribeirão das Neves;296317;296230;296210;20;87;3154606.0
Minas Gerais;Areias-Menezes;17321;17294;17294;0;27;3154606005010.0
Minas Gerais;Atalaia-Vila Fluminense;13820;13807;13807;0;13;3154606005014.0
Minas Gerais;Centro Justi-Jardim S Judas Tadeu;14538;14538;14538;0;0;3154606005015.0
Minas Gerais;Centro-Savassi;13578;13578;13578;0;0;3154606005008.0
Minas Gerais;Florença;16243;16243;16233;10;0;3154606005003.0
Minas Gerais;Fortaleza-Luar da Pampulha;15447;15447;15447;0;0;3154606005019.0
Minas Gerais;Girassol-Esperança;13737;13737;13737;0;0;3154606005013.0
Minas Gerais;Jardim Colonial-Vale das Acácias;15395;15395;15395;0;0;3154606005009.0
Minas Gerais;Jardim de Alá-São Joao de Deus;14623;14608;14608;0;15;3154606005018.0
Minas Gerais;Liberdade-Belvedere;16875;16875;16875;0;0;3154606005001.0
Minas Gerais;Maria Helena;13222;13222;13222;0;0;3154606005012.0
Minas Gerais;Pedra Branca-Landi;14821;14821;14821;0;0;3154606005011.0
Minas Gerais;Porto Seguro-Santa Martinha;16174;16174;16174;0;0;3154606005007.0
Minas Gerais;Rosaneves-Sevilha B;14385;14385;14385;0;0;3154606005005.0
Minas Gerais;San Genaro-Fazenda Castro;13797;13779;13779;0;18;3154606005004.0
Minas Gerais;Santinho-Bom Sossego;14110;14110;14110;0;0;3154606005006.0
Minas Gerais;São Jose-Santa Fé;14761;14761;14761;0;0;3154606005017.0
Minas Gerais;Veneza;13918;13918;13918;0;0;3154606005002.0
Minas Gerais;Vila Bispo de Maura-Soares;15116;15102;15092;10;14;3154606005020.0
Minas Gerais;Vila Braunas-Centro Justi;14436;14436;14436;0;0;3154606005016.0
Minas Gerais;Sabará;126269;126211;126196;15;58;3156700.0
Minas Gerais;Área 001;16457;16445;16445;0;12;3156700003001.0
Minas Gerais;Área 002;16298;16298;16283;15;0;3156700003002.0
Minas Gerais;Área 003;19609;19588;19588;0;21;3156700003003.0
Minas Gerais;Área 004;18324;18324;18324;0;0;3156700003004.0
Minas Gerais;Área 005;27917;27917;27917;0;0;3156700003005.0
Minas Gerais;Área 006;27664;27640;27640;0;24;3156700003006.0
Minas Gerais;Salinas;39178;39178;39178;0;0;3157005.0
Minas Gerais;Área 001;13549;13549;13549;0;0;3157005003001.0
Minas Gerais;Área 002;25629;25629;25629;0;0;3157005003002.0
Minas Gerais;Santa Luzia;202942;202893;202881;12;49;3157807.0
Minas Gerais;1-A;19140;19140;19137;3;0;3157807005001.0
Minas Gerais;2-A;23087;23076;23068;9;11;3157807005002.0
Minas Gerais;2-B;17574;17574;17574;0;0;3157807005003.0
Minas Gerais;2-C;16234;16224;16224;0;10;3157807005004.0
Minas Gerais;3-A;13852;13852;13852;0;0;3157807005005.0
Minas Gerais;3-B;20687;20687;20687;0;0;3157807005006.0
Minas Gerais;3-C;14985;14971;14971;0;14;3157807005009.0
Minas Gerais;3-D;15679;15679;15679;0;0;3157807005007.0
Minas Gerais;3-E;17003;16989;16989;0;14;3157807005008.0
Minas Gerais;3-F;15030;15030;15030;0;0;3157807005010.0
Minas Gerais;3-G;14938;14938;14938;0;0;3157807005011.0
Minas Gerais;3-H;14733;14733;14733;0;0;3157807005012.0
Minas Gerais;Santa Rita do Sapucaí;37754;37734;37716;19;20;3159605.0
Minas Gerais;Área 001;15114;15114;15095;19;0;3159605003001.0
Minas Gerais;Área 002;22640;22620;22620;0;20;3159605003002.0
Minas Gerais;Santo Antônio do Monte;25975;25962;25962;0;13;3160405.0
Minas Gerais;Área 001;12343;12343;12343;0;0;3160405003001.0
Minas Gerais;Área 002;13632;13619;13619;0;13;3160405003002.0
Minas Gerais;Santos Dumont;46284;46274;46256;18;10;3160702.0
Minas Gerais;Área 001;21033;21023;21005;18;10;3160702003001.0
Minas Gerais;Área 002;25251;25251;25251;0;0;3160702003002.0
Minas Gerais;São Francisco;53828;53820;53820;0;8;3161106.0
Minas Gerais;Área 001;25681;25681;25681;0;0;3161106003001.0
Minas Gerais;Área 002;28147;28139;28139;0;8;3161106003002.0
Minas Gerais;São Gotardo;31819;31800;31741;59;19;3162104.0
Minas Gerais;Área 001;13443;13443;13443;0;0;3162104003001.0
Minas Gerais;Área 002;18376;18357;18298;59;19;3162104003002.0
Minas Gerais;São João del Rei;84469;84423;84414;9;46;3162500.0
Minas Gerais;Área 001;13420;13420;13420;0;0;3162500003001.0
Minas Gerais;Área 002;13607;13599;13599;0;8;3162500003002.0
Minas Gerais;Área 003;13817;13808;13799;9;9;3162500003003.0
Minas Gerais;Área 004;21165;21155;21155;0;10;3162500003004.0
Minas Gerais;Área 005;22460;22441;22441;0;19;3162500003005.0
Minas Gerais;São Lourenço;41657;41405;41284;122;252;3163706.0
Minas Gerais;Área 001;21403;21317;21260;57;86;3163706003001.0
Minas Gerais;Área 002;20254;20089;20024;65;165;3163706003002.0
Minas Gerais;São Sebastião do Paraíso;64980;64955;64924;31;25;3164704.0
Minas Gerais;Área 001;12832;12832;12812;20;0;3164704003001.0
Minas Gerais;Área 002;26080;26069;26058;11;11;3164704003002.0
Minas Gerais;Área 003;26068;26054;26054;0;14;3164704003003.0
Minas Gerais;Sete Lagoas;214152;213972;213905;67;180;3167202.0
Minas Gerais;Área 001;16238;16238;16238;0;0;3167202005001.0
Minas Gerais;Área 002;15963;15963;15963;0;0;3167202005002.0
Minas Gerais;Área 003;20487;20487;20487;0;0;3167202005003.0
Minas Gerais;Área 004;16570;16570;16563;7;0;3167202005004.0
Minas Gerais;Área 005;16071;16055;16055;0;16;3167202005005.0
Minas Gerais;Área 006;15811;15811;15811;0;0;3167202005006.0
Minas Gerais;Área 007;13989;13989;13989;0;0;3167202005007.0
Minas Gerais;Área 008;21457;21380;21369;10;77;3167202005008.0
Minas Gerais;Área 009;13437;13427;13414;12;10;3167202005009.0
Minas Gerais;Área 010;15595;15595;15587;8;0;3167202005010.0
Minas Gerais;Área 011;14795;14745;14745;0;50;3167202005011.0
Minas Gerais;Área 012;13407;13382;13362;20;25;3167202005012.0
Minas Gerais;Área 013;20332;20332;20322;10;0;3167202005013.0
Minas Gerais;Taiobeiras;30917;30917;30917;0;0;3168002.0
Minas Gerais;Área 001;15379;15379;15379;0;0;3168002003001.0
Minas Gerais;Área 002;15538;15538;15538;0;0;3168002003002.0
Minas Gerais;Teófilo Otoni;134745;134669;134541;128;76;3168606.0
Minas Gerais;Área 001;13717;13717;13704;13;0;3168606003001.0
Minas Gerais;Área 002;36083;36018;35968;49;65;3168606003002.0
Minas Gerais;Área 003;16899;16888;16874;14;11;3168606003003.0
Minas Gerais;Área 004;18991;18991;18991;0;0;3168606003004.0
Minas Gerais;Área 005;24618;24618;24618;0;0;3168606003005.0
Minas Gerais;Área 006;24437;24437;24384;53;0;3168606003006.0
Minas Gerais;Timóteo;81243;81182;81134;48;61;3168705.0
Minas Gerais;Área 001;16575;16575;16575;0;0;3168705003001.0
Minas Gerais;Área 002;16176;16158;16150;8;18;3168705003002.0
Minas Gerais;Área 003;23322;23289;23261;28;33;3168705003003.0
Minas Gerais;Área 004;25170;25160;25148;12;10;3168705003004.0
Minas Gerais;Três Corações;72765;72673;72641;31;92;3169307.0
Minas Gerais;Área 001;14511;14511;14502;9;0;3169307003001.0
Minas Gerais;Área 002;27236;27207;27197;10;29;3169307003002.0
Minas Gerais;Área 003;31018;30955;30943;13;63;3169307003003.0
Minas Gerais;Três Pontas;53860;53850;53850;0;10;3169406.0
Minas Gerais;Área 001;25881;25881;25881;0;0;3169406003001.0
Minas Gerais;Área 002;27979;27969;27969;0;10;3169406003002.0
Minas Gerais;Tupaciguara;24188;24188;24188;0;0;3169604.0
Minas Gerais;Área 001;11511;11511;11511;0;0;3169604003001.0
Minas Gerais;Área 002;12677;12677;12677;0;0;3169604003002.0
Minas Gerais;Ubá;101519;101479;101466;14;40;3169901.0
Minas Gerais;Área 001;13769;13757;13743;14;12;3169901003001.0
Minas Gerais;Área 002;14371;14354;14354;0;17;3169901003002.0
Minas Gerais;Área 003;18317;18317;18317;0;0;3169901003003.0
Minas Gerais;Área 004;13491;13491;13491;0;0;3169901003004.0
Minas Gerais;Área 005;19215;19215;19215;0;0;3169901003005.0
Minas Gerais;Área 006;22356;22346;22346;0;10;3169901003006.0
Minas Gerais;Uberaba;295988;295644;295360;283;344;3170107.0
Minas Gerais;Abadia;19708;19662;19650;11;46;3170107005005.0
Minas Gerais;Alfredo Freire;16506;16506;16492;14;0;3170107005013.0
Minas Gerais;Amoroso Costa-;28609;28600;28567;33;9;3170107005009.0
Minas Gerais;Boa Vista;24071;24060;24040;20;11;3170107005008.0
Minas Gerais;Centro-São Benedito;20992;20945;20921;25;47;3170107005001.0
Minas Gerais;Costa Teles;17886;17886;17886;0;0;3170107005010.0
Minas Gerais;Entorno;12701;12687;12645;42;14;3170107005016.0
Minas Gerais;Estados Unidos;19955;19878;19849;28;77;3170107005004.0
Minas Gerais;Fabrício;17925;17916;17885;30;9;3170107005003.0
Minas Gerais;Grande Horizonte;12932;12915;12904;11;17;3170107005007.0
Minas Gerais;Leblon-São Cristovão;18433;18421;18398;23;12;3170107005011.0
Minas Gerais;Lourdes-2000;16786;16770;16770;0;16;3170107005014.0
Minas Gerais;Mercês;12755;12699;12677;22;56;3170107005002.0
Minas Gerais;Parque das Américas;18667;18667;18667;0;0;3170107005012.0
Minas Gerais;Santa Maria-O;17781;17766;17742;24;15;3170107005006.0
Minas Gerais;Vallim-Recreio dos Bandeirantes;20281;20266;20266;0;15;3170107005015.0
Minas Gerais;Uberlândia;604013;603274;603012;262;739;3170206.0
Minas Gerais;Centro 1;32159;32117;32078;39;42;3170206005005.0
Minas Gerais;Centro 2;31759;31653;31638;15;106;3170206005006.0
Minas Gerais;Centro 3;20985;20934;20843;90;51;3170206005007.0
Minas Gerais;Leste 1;51479;51366;51366;0;113;3170206005011.0
Minas Gerais;Leste 2;32524;32454;32433;21;70;3170206005012.0
Minas Gerais;Leste 3;54274;54247;54221;26;27;3170206005013.0
Minas Gerais;Norte 1;36128;36071;36071;0;57;3170206005008.0
Minas Gerais;Norte 2;29679;29634;29634;0;45;3170206005009.0
Minas Gerais;Norte 3;27460;27426;27426;0;34;3170206005010.0
Minas Gerais;Oeste 1;36808;36808;36808;0;0;3170206005001.0
Minas Gerais;Oeste 2;30161;30145;30145;0;16;3170206005002.0
Minas Gerais;Oeste 3;43289;43271;43254;18;18;3170206005003.0
Minas Gerais;Oeste 4;30281;30281;30281;0;0;3170206005004.0
Minas Gerais;Sul 1;43155;43104;43104;0;51;3170206005014.0
Minas Gerais;Sul 2;53059;53059;53023;36;0;3170206005015.0
Minas Gerais;Sul 3;30902;30793;30776;17;109;3170206005016.0
Minas Gerais;Zona Rural;19911;19911;19911;0;0;3170206005017.0
Minas Gerais;Unaí;77565;77488;77443;44;77;3170404.0
Minas Gerais;Área 001;14830;14820;14820;0;10;3170404003001.0
Minas Gerais;Área 002;15625;15625;15615;10;0;3170404003002.0
Minas Gerais;Área 003;16598;16531;16521;9;67;3170404003003.0
Minas Gerais;Área 004;30512;30512;30487;25;0;3170404003004.0
Minas Gerais;Varginha;123081;123051;123025;26;30;3170701.0
Minas Gerais;Área 001;13772;13761;13761;0;11;3170701003001.0
Minas Gerais;Área 002;15227;15227;15227;0;0;3170701003002.0
Minas Gerais;Área 003;17021;17021;17021;0;0;3170701003003.0
Minas Gerais;Área 004;15031;15031;15020;11;0;3170701003004.0
Minas Gerais;Área 005;20286;20286;20271;15;0;3170701003005.0
Minas Gerais;Área 006;20108;20089;20089;0;19;3170701003006.0
Minas Gerais;Área 007;21636;21636;21636;0;0;3170701003007.0
Minas Gerais;Várzea da Palma;35809;35765;35765;0;44;3170800.0
Minas Gerais;Área 001;15878;15878;15878;0;0;3170800003001.0
Minas Gerais;Área 002;19931;19887;19887;0;44;3170800003002.0
Minas Gerais;Vespasiano;104527;104479;104436;43;48;3171204.0
Minas Gerais;Área 001;14990;14990;14988;2;0;3171204003001.0
Minas Gerais;Área 002;14872;14872;14872;0;0;3171204003002.0
Minas Gerais;Área 003;20512;20512;20482;30;0;3171204003003.0
Minas Gerais;Área 004;25088;25040;25030;11;48;3171204003004.0
Minas Gerais;Área 005;29065;29065;29065;0;0;3171204003005.0
Minas Gerais;Viçosa;72220;72086;71994;92;134;3171303.0
Minas Gerais;Área 001;14911;14895;14833;62;16;3171303003001.0
Minas Gerais;Área 002;14550;14540;14540;0;10;3171303003002.0
Minas Gerais;Área 003;20803;20778;20778;0;25;3171303003003.0
Minas Gerais;Área 004;21956;21873;21843;30;83;3171303003004.0
Minas Gerais;Visconde do Rio Branco;37942;37942;37932;10;0;3172004.0
Minas Gerais;Área 001;16718;16718;16718;0;0;3172004003001.0
Minas Gerais;Área 002;21224;21224;21214;10;0;3172004003002.0
Espírito Santo;Afonso Cláudio;31091;31091;31091;0;0;3200102.0
Espírito Santo;Área 001;14779;14779;14779;0;0;3200102003001.0
Espírito Santo;Área 002;16312;16312;16312;0;0;3200102003002.0
Espírito Santo;Alegre;30768;30768;30768;0;0;3200201.0
Espírito Santo;Área 001;14671;14671;14671;0;0;3200201003001.0
Espírito Santo;Área 002;16097;16097;16097;0;0;3200201003002.0
Espírito Santo;Aracruz;81832;81760;81718;42;72;3200607.0
Espírito Santo;Área 001;14739;14729;14729;0;10;3200607003001.0
Espírito Santo;Área 002;14546;14546;14546;0;0;3200607003002.0
Espírito Santo;Área 003;22128;22108;22108;0;20;3200607003003.0
Espírito Santo;Área 004;30419;30376;30335;42;43;3200607003004.0
Espírito Santo;Baixo Guandu;29081;29066;29055;11;15;3200805.0
Espírito Santo;Área 001;13193;13178;13167;11;15;3200805003001.0
Espírito Santo;Área 002;15888;15888;15888;0;0;3200805003002.0
Espírito Santo;Barra de São Francisco;40649;40605;40569;36;44;3200904.0
Espírito Santo;Área 001;16500;16500;16500;0;0;3200904003001.0
Espírito Santo;Área 002;24149;24105;24069;36;44;3200904003002.0
Espírito Santo;Cachoeiro de Itapemirim;189889;189881;189852;29;8;3201209.0
Espírito Santo;Área 001;13238;13238;13238;0;0;3201209003001.0
Espírito Santo;Área 002;38659;38659;38659;0;0;3201209003002.0
Espírito Santo;Área 003;14460;14460;14460;0;0;3201209003003.0
Espírito Santo;Área 004;18982;18982;18962;20;0;3201209003004.0
Espírito Santo;Área 005;16471;16463;16463;0;8;3201209003005.0
Espírito Santo;Área 006;17057;17057;17049;8;0;3201209003006.0
Espírito Santo;Área 007;14334;14334;14334;0;0;3201209003007.0
Espírito Santo;Área 008;27908;27908;27908;0;0;3201209003008.0
Espírito Santo;Área 009;28780;28780;28780;0;0;3201209003009.0
Espírito Santo;Cariacica;348738;348670;348598;72;68;3201308.0
Espírito Santo;Região 01-1;15270;15270;15270;0;0;3201308005001.0
Espírito Santo;Região 01-2;27695;27695;27685;10;0;3201308005002.0
Espírito Santo;Região 02;25689;25689;25678;11;0;3201308005003.0
Espírito Santo;Região 03;32365;32365;32354;11;0;3201308005004.0
Espírito Santo;Região 04-1;16913;16895;16888;8;18;3201308005005.0
Espírito Santo;Região 04-2;35668;35643;35643;0;25;3201308005006.0
Espírito Santo;Região 05;16839;16839;16839;0;0;3201308005007.0
Espírito Santo;Região 06-1;15753;15740;15731;9;13;3201308005008.0
Espírito Santo;Região 06-2;19679;19679;19666;13;0;3201308005009.0
Espírito Santo;Região 07;32886;32873;32873;0;13;3201308005010.0
Espírito Santo;Região 08;19730;19730;19730;0;0;3201308005011.0
Espírito Santo;Região 09;24113;24113;24113;0;0;3201308005012.0
Espírito Santo;Região 10;27618;27618;27607;11;0;3201308005013.0
Espírito Santo;Região 11;16359;16359;16359;0;0;3201308005014.0
Espírito Santo;Região 12;22161;22161;22161;0;0;3201308005015.0
Espírito Santo;Castelo;34747;34747;34747;0;0;3201407.0
Espírito Santo;Área 001;15174;15174;15174;0;0;3201407003001.0
Espírito Santo;Área 002;19573;19573;19573;0;0;3201407003002.0
Espírito Santo;Colatina;111788;111754;111704;50;34;3201506.0
Espírito Santo;Área 001;13978;13973;13973;0;5;3201506003001.0
Espírito Santo;Área 002;13002;13002;13002;0;0;3201506003002.0
Espírito Santo;Área 003;14034;14034;14034;0;0;3201506003003.0
Espírito Santo;Área 004;15395;15395;15395;0;0;3201506003004.0
Espírito Santo;Área 005;12812;12812;12812;0;0;3201506003005.0
Espírito Santo;Área 006;21507;21478;21449;29;29;3201506003006.0
Espírito Santo;Área 007;21060;21060;21039;21;0;3201506003007.0
Espírito Santo;Conceição da Barra;28449;28449;28434;15;0;3201605.0
Espírito Santo;Área 001;13114;13114;13099;15;0;3201605003001.0
Espírito Santo;Área 002;15335;15335;15335;0;0;3201605003002.0
Espírito Santo;Domingos Martins;31847;31847;31836;11;0;3201902.0
Espírito Santo;Área 001;15436;15436;15425;11;0;3201902003001.0
Espírito Santo;Área 002;16411;16411;16411;0;0;3201902003002.0
Espírito Santo;Guaçuí;27851;27851;27839;12;0;3202306.0
Espírito Santo;Área 001;12697;12697;12685;12;0;3202306003001.0
Espírito Santo;Área 002;15154;15154;15154;0;0;3202306003002.0
Espírito Santo;Guarapari;105286;105030;104997;33;256;3202405.0
Espírito Santo;Área 001;13934;13858;13845;13;76;3202405003001.0
Espírito Santo;Área 002;17125;17113;17113;0;12;3202405003002.0
Espírito Santo;Área 003;13208;13204;13204;0;4;3202405003003.0
Espírito Santo;Área 004;15689;15585;15577;8;104;3202405003004.0
Espírito Santo;Área 005;17901;17893;17893;0;8;3202405003005.0
Espírito Santo;Área 006;27429;27377;27365;12;52;3202405003006.0
Espírito Santo;Itapemirim;30988;30988;30988;0;0;3202801.0
Espírito Santo;Área 001;13474;13474;13474;0;0;3202801003001.0
Espírito Santo;Área 002;17514;17514;17514;0;0;3202801003002.0
Espírito Santo;Iúna;27328;27328;27328;0;0;3203007.0
Espírito Santo;Área 001;12343;12343;12343;0;0;3203007003001.0
Espírito Santo;Área 002;14985;14985;14985;0;0;3203007003002.0
Espírito Santo;Linhares;141306;141252;141233;19;54;3203205.0
Espírito Santo;Área 001;16003;16003;16003;0;0;3203205003001.0
Espírito Santo;Área 002;14164;14164;14164;0;0;3203205003002.0
Espírito Santo;Área 003;21872;21872;21872;0;0;3203205003003.0
Espírito Santo;Área 004;14143;14133;14126;7;10;3203205003004.0
Espírito Santo;Área 005;19684;19652;19652;0;32;3203205003005.0
Espírito Santo;Área 006;28229;28229;28229;0;0;3203205003006.0
Espírito Santo;Área 007;27211;27200;27187;12;11;3203205003007.0
Espírito Santo;Marataízes;34140;34113;34102;11;27;3203320.0
Espírito Santo;Área 001;13979;13972;13972;0;7;3203320003001.0
Espírito Santo;Área 002;20161;20141;20130;11;20;3203320003002.0
Espírito Santo;Nova Venécia;46031;45984;45973;11;47;3203908.0
Espírito Santo;Área 001;21707;21696;21686;11;11;3203908003001.0
Espírito Santo;Área 002;24324;24287;24287;0;37;3203908003002.0
Espírito Santo;Santa Maria de Jetibá;34176;34176;34176;0;0;3204559.0
Espírito Santo;Área 001;15447;15447;15447;0;0;3204559003001.0
Espírito Santo;Área 002;18729;18729;18729;0;0;3204559003002.0
Espírito Santo;São Gabriel da Palha;31859;31850;31837;13;9;3204708.0
Espírito Santo;Área 001;13883;13883;13883;0;0;3204708003001.0
Espírito Santo;Área 002;17976;17967;17954;13;9;3204708003002.0
Espírito Santo;São Mateus;109028;108897;108835;62;131;3204906.0
Espírito Santo;Área 001;13255;13178;13149;29;77;3204906003001.0
Espírito Santo;Área 002;15274;15274;15274;0;0;3204906003002.0
Espírito Santo;Área 003;13339;13330;13297;33;9;3204906003003.0
Espírito Santo;Área 004;19356;19321;19321;0;35;3204906003004.0
Espírito Santo;Área 005;18276;18276;18276;0;0;3204906003005.0
Espírito Santo;Área 006;29528;29518;29518;0;10;3204906003006.0
Espírito Santo;Serra;409267;408731;408536;196;536;3205002.0
Espírito Santo;Castelândia 1;19786;19775;19775;0;11;3205002005001.0
Espírito Santo;Castelândia 2;26221;26194;26194;0;27;3205002005002.0
Espírito Santo;Novo Horizonte;14146;14146;14146;0;0;3205002005004.0
Espírito Santo;Região Anchieta 1;23146;23146;23146;0;0;3205002005020.0
Espírito Santo;Região Anchieta 2;22600;22600;22600;0;0;3205002005021.0
Espírito Santo;Região Carapina 1;17488;17480;17480;0;8;3205002005010.0
Espírito Santo;Região Carapina 2;22805;22766;22766;0;39;3205002005011.0
Espírito Santo;Região Civit A1;16599;16541;16529;12;58;3205002005012.0
Espírito Santo;Região Civit A2;14863;14827;14817;11;36;3205002005013.0
Espírito Santo;Região Civit A3;23130;23070;23070;0;60;3205002005014.0
Espírito Santo;Região Civit B;26250;26240;26240;0;10;3205002005015.0
Espírito Santo;Região Laranjeiras 1;27103;27093;27029;64;10;3205002005009.0
Espírito Santo;Região Laranjeiras 2;15303;15297;15297;0;6;3205002005008.0
Espírito Santo;Região Praia I1;15542;15467;15442;26;75;3205002005005.0
Espírito Santo;Região Praia I2;19431;19369;19358;11;62;3205002005006.0
Espírito Santo;Região Praia II;23087;22993;22961;32;94;3205002005003.0
Espírito Santo;Região Praia III;16060;16029;15996;33;31;3205002005007.0
Espírito Santo;Região Serra A1;16624;16624;16616;8;0;3205002005016.0
Espírito Santo;Região Serra A2;15151;15151;15151;0;0;3205002005017.0
Espírito Santo;Região Serra B1;19252;19252;19252;0;0;3205002005019.0
Espírito Santo;Região Serra B2;14680;14672;14672;0;8;3205002005018.0
Espírito Santo;Viana;65001;64900;64875;25;101;3205101.0
Espírito Santo;Área 001;17299;17299;17299;0;0;3205101003001.0
Espírito Santo;Área 002;22810;22709;22684;25;101;3205101003002.0
Espírito Santo;Área 003;24892;24892;24892;0;0;3205101003003.0
Espírito Santo;Vila Velha;414586;413575;413179;396;1011;3205200.0
Espírito Santo;Região 1;15911;15879;15866;13;32;3205200005001.0
Espírito Santo;Região 1-1;31083;30785;30667;118;298;3205200005002.0
Espírito Santo;Região 1-2;22808;22729;22692;36;79;3205200005003.0
Espírito Santo;Região 1-3;20748;20613;20598;16;135;3205200005004.0
Espírito Santo;Região 1-4;19170;19141;19115;26;29;3205200005005.0
Espírito Santo;Região 1-5;15024;15014;15014;0;10;3205200005006.0
Espírito Santo;Região 1-6;22682;22622;22570;51;60;3205200005007.0
Espírito Santo;Região 2;15458;15436;15419;17;22;3205200005008.0
Espírito Santo;Região 2-1;15456;15437;15413;24;19;3205200005009.0
Espírito Santo;Região 2-2;15265;15233;15223;10;32;3205200005010.0
Espírito Santo;Região 2-3;23372;23295;23269;26;77;3205200005011.0
Espírito Santo;Região 3;17689;17655;17655;0;34;3205200005012.0
Espírito Santo;Região 3-1;19267;19267;19267;0;0;3205200005013.0
Espírito Santo;Região 3-2;16629;16629;16629;0;0;3205200005014.0
Espírito Santo;Região 3-3;15250;15236;15223;14;14;3205200005015.0
Espírito Santo;Região 4;23473;23399;23390;10;74;3205200005016.0
Espírito Santo;Região 4-1;18580;18573;18573;0;7;3205200005017.0
Espírito Santo;Região 4-2;23975;23964;23964;0;11;3205200005018.0
Espírito Santo;Região 5;62746;62667;62631;36;79;3205200005019.0
Espírito Santo;Vitória;327801;326735;326283;452;1066;3205309.0
Espírito Santo;Região 1;18683;18635;18607;27;48;3205309005001.0
Espírito Santo;Região 2a;15701;15689;15689;0;12;3205309005002.0
Espírito Santo;Região 2b;22173;22161;22151;10;12;3205309005003.0
Espírito Santo;Região 3;31785;31594;31552;42;191;3205309005004.0
Espírito Santo;Região 4a;17651;17642;17634;8;9;3205309005005.0
Espírito Santo;Região 4b;13340;13325;13315;9;15;3205309005006.0
Espírito Santo;Região 4c;24214;24165;24143;22;49;3205309005007.0
Espírito Santo;Região 5a;19089;19010;18976;34;79;3205309005008.0
Espírito Santo;Região 5b;15147;14988;14894;94;159;3205309005009.0
Espírito Santo;Região 6a;42712;42553;42445;107;159;3205309005010.0
Espírito Santo;Região 6b;13226;13194;13173;21;32;3205309005011.0
Espírito Santo;Região 6c;13197;13181;13150;32;16;3205309005012.0
Espírito Santo;Região 7;33746;33735;33735;0;11;3205309005013.0
Espírito Santo;Região 8;47137;46863;46818;45;274;3205309005014.0
Rio de Janeiro;Angra dos Reis;169511;169071;169048;23;440;3300100.0
Rio de Janeiro;Área 001;17094;17057;17045;12;37;3300100003001.0
Rio de Janeiro;Área 002;48022;47897;47897;0;125;3300100003002.0
Rio de Janeiro;Área 003;19945;19853;19842;11;92;3300100003003.0
Rio de Janeiro;Área 004;17292;17274;17274;0;18;3300100003004.0
Rio de Janeiro;Área 005;14084;13972;13972;0;112;3300100003005.0
Rio de Janeiro;Área 006;25980;25936;25936;0;44;3300100003006.0
Rio de Janeiro;Área 007;27094;27083;27083;0;11;3300100003007.0
Rio de Janeiro;Araruama;112008;111576;111412;164;432;3300209.0
Rio de Janeiro;Área 001;14334;14315;14315;0;19;3300209003001.0
Rio de Janeiro;Área 002;13787;13759;13724;36;28;3300209003002.0
Rio de Janeiro;Área 003;18712;18640;18576;64;72;3300209003003.0
Rio de Janeiro;Área 004;18914;18853;18842;11;61;3300209003004.0
Rio de Janeiro;Área 005;22047;21906;21888;18;141;3300209003005.0
Rio de Janeiro;Área 006;24214;24103;24068;35;111;3300209003006.0
Rio de Janeiro;Armação dos Búzios;27560;27073;26929;144;487;3300233.0
Rio de Janeiro;Área 001;13410;13348;13339;9;62;3300233003001.0
Rio de Janeiro;Área 002;14150;13725;13590;135;425;3300233003002.0
Rio de Janeiro;Barra do Piraí;94778;94745;94745;0;33;3300308.0
Rio de Janeiro;Área 001;13298;13298;13298;0;0;3300308003001.0
Rio de Janeiro;Área 002;13688;13676;13676;0;12;3300308003002.0
Rio de Janeiro;Área 003;13776;13776;13776;0;0;3300308003003.0
Rio de Janeiro;Área 004;13328;13328;13328;0;0;3300308003004.0
Rio de Janeiro;Área 005;18416;18416;18416;0;0;3300308003005.0
Rio de Janeiro;Área 006;22272;22251;22251;0;21;3300308003006.0
Rio de Janeiro;Barra Mansa;177813;177722;177683;39;91;3300407.0
Rio de Janeiro;Área 001;11881;11863;11863;0;18;3300407003001.0
Rio de Janeiro;Área 002;17243;17231;17222;8;12;3300407003002.0
Rio de Janeiro;Área 003;14142;14142;14142;0;0;3300407003003.0
Rio de Janeiro;Área 004;14927;14914;14893;20;13;3300407003004.0
Rio de Janeiro;Área 005;12695;12661;12651;10;34;3300407003005.0
Rio de Janeiro;Área 006;46628;46620;46620;0;8;3300407003006.0
Rio de Janeiro;Área 007;11322;11316;11316;0;6;3300407003007.0
Rio de Janeiro;Área 008;24299;24299;24299;0;0;3300407003008.0
Rio de Janeiro;Área 009;24676;24676;24676;0;0;3300407003009.0
Rio de Janeiro;Belford Roxo;469332;468931;468889;42;401;3300456.0
Rio de Janeiro;Areia Branca;112182;112051;112030;22;131;3300456005001.0
Rio de Janeiro;Jardim Redentor;91988;91843;91843;0;145;3300456005003.0
Rio de Janeiro;Lote XV;97031;96972;96952;20;59;3300456005005.0
Rio de Janeiro;Nova Aurora;94645;94622;94622;0;23;3300456005002.0
Rio de Janeiro;Parque São José;73486;73442;73442;0;44;3300456005004.0
Rio de Janeiro;Bom Jesus do Itabapoana;35411;35411;35411;0;0;3300605.0
Rio de Janeiro;Área 001;13930;13930;13930;0;0;3300605003001.0
Rio de Janeiro;Área 002;21481;21481;21481;0;0;3300605003002.0
Rio de Janeiro;Cabo Frio;186227;185668;185496;172;559;3300704.0
Rio de Janeiro;Área 001;14029;14018;14018;0;11;3300704003001.0
Rio de Janeiro;Área 002;45958;45871;45861;10;87;3300704003002.0
Rio de Janeiro;Área 003;15276;15199;15177;22;77;3300704003003.0
Rio de Janeiro;Área 004;17833;17756;17756;0;77;3300704003004.0
Rio de Janeiro;Área 005;14612;14600;14600;0;12;3300704003005.0
Rio de Janeiro;Área 006;17313;17214;17185;29;99;3300704003006.0
Rio de Janeiro;Área 007;14766;14701;14640;61;65;3300704003007.0
Rio de Janeiro;Área 008;20232;20156;20147;9;76;3300704003008.0
Rio de Janeiro;Área 009;26208;26152;26111;41;56;3300704003009.0
Rio de Janeiro;Cachoeiras de Macacu;54273;54192;54170;22;81;3300803.0
Rio de Janeiro;Área 001;27584;27553;27553;0;31;3300803003001.0
Rio de Janeiro;Área 002;26689;26640;26617;22;49;3300803003002.0
Rio de Janeiro;Campos dos Goytacazes;463731;463418;463282;136;313;3301009.0
Rio de Janeiro;Dores de Macacbu-Ibitioca-Morangaba e Serrinha;16564;16564;16564;0;0;3301009005008.0
Rio de Janeiro;Mussurepe-São Sebastião;26514;26502;26485;17;12;3301009005005.0
Rio de Janeiro;Subdistrito 1;73802;73743;73733;10;59;3301009005001.0
Rio de Janeiro;Subdistrito 2;110202;109983;109897;86;219;3301009005002.0
Rio de Janeiro;Subdistrito 3;130467;130445;130445;0;22;3301009005003.0
Rio de Janeiro;Subdistrito 4;46198;46198;46198;0;0;3301009005004.0
Rio de Janeiro;Tócos-Santo Amaro;16117;16117;16104;13;0;3301009005007.0
Rio de Janeiro;Travessão;24058;24058;24058;0;0;3301009005009.0
Rio de Janeiro;Vila Nova-Morro do Coco-Santa Maria-Santo Eduardo;19809;19809;19799;10;0;3301009005006.0
Rio de Janeiro;Casimiro de Abreu;35347;35218;35194;24;129;3301306.0
Rio de Janeiro;Área 001;12843;12808;12784;24;35;3301306003001.0
Rio de Janeiro;Área 002;22504;22410;22410;0;94;3301306003002.0
Rio de Janeiro;Duque de Caxias;855048;853407;852980;427;1641;3301702.0
Rio de Janeiro;Área 0;259157;258631;258515;116;526;3301702005000.0
Rio de Janeiro;Área 1;24400;24288;24211;76;112;3301702005001.0
Rio de Janeiro;Área 2;27357;27309;27309;0;48;3301702005002.0
Rio de Janeiro;Área 3;26697;26676;26676;0;21;3301702005003.0
Rio de Janeiro;Área 4;33358;33313;33313;0;45;3301702005004.0
Rio de Janeiro;Área 5;27993;27914;27914;0;79;3301702005005.0
Rio de Janeiro;Área A;24270;24220;24220;0;50;3301702005006.0
Rio de Janeiro;Área B;25726;25665;25665;0;61;3301702005007.0
Rio de Janeiro;Área C;23891;23785;23785;0;106;3301702005008.0
Rio de Janeiro;Área D;26961;26900;26855;44;61;3301702005009.0
Rio de Janeiro;Área E;25836;25696;25696;0;140;3301702005010.0
Rio de Janeiro;Área F;28812;28720;28679;41;92;3301702005011.0
Rio de Janeiro;Área G;27618;27562;27507;55;56;3301702005012.0
Rio de Janeiro;Área H;25780;25780;25780;0;0;3301702005013.0
Rio de Janeiro;Área I;25441;25441;25441;0;0;3301702005014.0
Rio de Janeiro;Área J;27928;27829;27829;0;99;3301702005015.0
Rio de Janeiro;Área K;27159;27134;27094;39;25;3301702005016.0
Rio de Janeiro;Área L;27482;27415;27381;34;67;3301702005017.0
Rio de Janeiro;Área M;27166;27137;27116;21;29;3301702005018.0
Rio de Janeiro;Área N;28607;28607;28607;0;0;3301702005019.0
Rio de Janeiro;Área O;27676;27676;27676;0;0;3301702005020.0
Rio de Janeiro;Área P;26335;26311;26311;0;24;3301702005021.0
Rio de Janeiro;Área Q;29398;29398;29398;0;0;3301702005022.0
Rio de Janeiro;Guapimirim;51483;51357;51325;32;126;3301850.0
Rio de Janeiro;Área 001;17075;17075;17055;20;0;3301850003001.0
Rio de Janeiro;Área 002;34408;34282;34270;12;126;3301850003002.0
Rio de Janeiro;Itaboraí;218008;217814;217696;118;194;3301900.0
Rio de Janeiro;Área 001;17527;17468;17468;0;59;3301900005001.0
Rio de Janeiro;Área 002;18681;18681;18671;10;0;3301900005002.0
Rio de Janeiro;Área 003;15106;15097;15097;0;9;3301900005003.0
Rio de Janeiro;Área 004;14903;14903;14893;10;0;3301900005004.0
Rio de Janeiro;Área 005;15827;15827;15799;28;0;3301900005005.0
Rio de Janeiro;Área 006;14363;14363;14363;0;0;3301900005006.0
Rio de Janeiro;Área 007;23068;23026;23007;19;42;3301900005007.0
Rio de Janeiro;Área 008;16850;16831;16831;0;19;3301900005008.0
Rio de Janeiro;Área 009;23111;23090;23079;11;21;3301900005009.0
Rio de Janeiro;Área 010;14511;14491;14484;7;20;3301900005010.0
Rio de Janeiro;Área 011;30111;30093;30061;32;18;3301900005011.0
Rio de Janeiro;Área 012;13950;13943;13943;0;7;3301900005012.0
Rio de Janeiro;Itaguaí;109091;108856;108822;34;235;3302007.0
Rio de Janeiro;Área 001;14345;14326;14321;6;19;3302007003001.0
Rio de Janeiro;Área 002;15516;15507;15501;6;9;3302007003002.0
Rio de Janeiro;Área 003;16461;16422;16422;0;39;3302007003003.0
Rio de Janeiro;Área 004;14844;14833;14833;0;11;3302007003004.0
Rio de Janeiro;Área 005;22269;22128;22105;23;141;3302007003005.0
Rio de Janeiro;Área 006;25656;25640;25640;0;16;3302007003006.0
Rio de Janeiro;Itaperuna;95841;95794;95764;30;47;3302205.0
Rio de Janeiro;Área 001;16168;16158;16144;14;10;3302205003001.0
Rio de Janeiro;Área 002;15099;15073;15073;0;26;3302205003002.0
Rio de Janeiro;Área 003;18340;18340;18324;16;0;3302205003003.0
Rio de Janeiro;Área 004;22761;22751;22751;0;10;3302205003004.0
Rio de Janeiro;Área 005;23473;23473;23473;0;0;3302205003005.0
Rio de Janeiro;Japeri;95492;95424;95402;23;68;3302270.0
Rio de Janeiro;Área 001;15837;15820;15820;0;17;3302270003001.0
Rio de Janeiro;Área 002;14239;14239;14228;11;0;3302270003002.0
Rio de Janeiro;Área 003;15609;15559;15559;0;50;3302270003003.0
Rio de Janeiro;Área 004;24318;24318;24318;0;0;3302270003004.0
Rio de Janeiro;Área 005;25489;25489;25478;11;0;3302270003005.0
Rio de Janeiro;Macaé;206728;206139;205936;203;589;3302403.0
Rio de Janeiro;Aroeira;15700;15700;15688;12;0;3302403005010.0
Rio de Janeiro;Barra de Macaé 1;17595;17595;17595;0;0;3302403005001.0
Rio de Janeiro;Barra de Macaé 2;14767;14767;14752;15;0;3302403005002.0
Rio de Janeiro;Botafogo e Virgem Santa;12933;12933;12933;0;0;3302403005011.0
Rio de Janeiro;Cabiúnas-São José do Barreto-Rural Ajuda e Sub 2;14799;14799;14799;0;0;3302403005004.0
Rio de Janeiro;Centro-Imbetiba-Cajueiros;18364;18285;18245;40;79;3302403005007.0
Rio de Janeiro;Imboassica-Lagoa-Vale Encantado-Granja dos Cavaleiros-Glória e Cavaleiros;20132;19852;19794;59;280;3302403005006.0
Rio de Janeiro;Lagomar;20804;20794;20783;11;10;3302403005005.0
Rio de Janeiro;Miramar e Visconde de Araújo;17754;17716;17702;13;38;3302403005008.0
Rio de Janeiro;Nova Cidade, -Rural Sub 3-Cachoeiros de Macaé-Córrego do Ouro-Frade-Glicério-Sana;14112;14112;14112;0;0;3302403005012.0
Rio de Janeiro;Parque Aeroporto;25138;25085;25053;31;53;3302403005003.0
Rio de Janeiro;Praia Campista e Riviera Fluminense;14630;14502;14480;22;128;3302403005009.0
Rio de Janeiro;Magé;227322;227060;226920;141;262;3302502.0
Rio de Janeiro;Guia de Pacobaiba;25132;25039;25014;25;93;3302502005003.0
Rio de Janeiro;Inhomirim 1;37429;37418;37375;43;11;3302502005001.0
Rio de Janeiro;Inhomirim 2;77023;76954;76954;0;69;3302502005002.0
Rio de Janeiro;Mage 1;32028;31967;31923;44;61;3302502005006.0
Rio de Janeiro;Mage 2;24336;24308;24290;19;28;3302502005007.0
Rio de Janeiro;Santo Aleixo;12414;12414;12404;10;0;3302502005005.0
Rio de Janeiro;Surui;18960;18960;18960;0;0;3302502005004.0
Rio de Janeiro;Mangaratiba;36456;36284;36232;51;172;3302601.0
Rio de Janeiro;Área 001;15138;15064;15026;39;74;3302601003001.0
Rio de Janeiro;Área 002;21318;21219;21207;13;99;3302601003002.0
Rio de Janeiro;Maricá;127461;126879;126679;201;582;3302700.0
Rio de Janeiro;Área 001;13123;13074;13067;7;49;3302700003001.0
Rio de Janeiro;Área 002;12395;12314;12249;65;81;3302700003002.0
Rio de Janeiro;Área 003;14616;14606;14596;10;10;3302700003003.0
Rio de Janeiro;Área 004;25175;25078;25025;53;97;3302700003004.0
Rio de Janeiro;Área 005;12423;12337;12337;0;86;3302700003005.0
Rio de Janeiro;Área 006;15442;15349;15339;10;93;3302700003006.0
Rio de Janeiro;Área 007;34287;34121;34066;55;166;3302700003007.0
Rio de Janeiro;Mesquita;168376;168020;167957;63;356;3302858.0
Rio de Janeiro;Área 001;15077;15031;15013;18;46;3302858003001.0
Rio de Janeiro;Área 002;18339;18303;18291;12;36;3302858003002.0
Rio de Janeiro;Área 003;18094;18053;18053;0;41;3302858003003.0
Rio de Janeiro;Área 004;15676;15619;15619;0;57;3302858003004.0
Rio de Janeiro;Área 005;19124;19093;19093;0;31;3302858003005.0
Rio de Janeiro;Área 006;21676;21676;21643;33;0;3302858003006.0
Rio de Janeiro;Área 007;14167;14093;14093;0;74;3302858003007.0
Rio de Janeiro;Área 008;23375;23318;23318;0;57;3302858003008.0
Rio de Janeiro;Área 009;22848;22833;22833;0;15;3302858003009.0
Rio de Janeiro;Nilópolis;157425;156947;156864;82;478;3303203.0
Rio de Janeiro;Área 001;19994;19974;19974;0;20;3303203003001.0
Rio de Janeiro;Área 002;14380;14360;14360;0;20;3303203003002.0
Rio de Janeiro;Área 003;15256;15188;15188;0;68;3303203003003.0
Rio de Janeiro;Área 004;20848;20799;20775;24;49;3303203003004.0
Rio de Janeiro;Área 005;15630;15607;15594;13;23;3303203003005.0
Rio de Janeiro;Área 006;12955;12922;12922;0;33;3303203003006.0
Rio de Janeiro;Área 007;16119;16059;16050;9;60;3303203003007.0
Rio de Janeiro;Área 008;20807;20709;20690;19;98;3303203003008.0
Rio de Janeiro;Área 009;21436;21327;21310;17;109;3303203003009.0
Rio de Janeiro;Niterói;487562;483821;482532;1289;3741;3303302.0
Rio de Janeiro;Área 001;17730;17540;17454;86;190;3303302005001.0
Rio de Janeiro;Área 002;14748;14555;14535;20;193;3303302005002.0
Rio de Janeiro;Área 003;19284;19177;19071;107;107;3303302005003.0
Rio de Janeiro;Área 004;17212;17101;17061;40;111;3303302005004.0
Rio de Janeiro;Área 005;20630;20446;20439;7;184;3303302005005.0
Rio de Janeiro;Área 006;22985;22878;22864;14;107;3303302005006.0
Rio de Janeiro;Área 007;24933;24886;24832;55;47;3303302005007.0
Rio de Janeiro;Área 008;22307;22278;22278;0;29;3303302005008.0
Rio de Janeiro;Área 009;22116;21982;21958;23;134;3303302005009.0
Rio de Janeiro;Área 010;41733;41376;41191;185;357;3303302005010.0
Rio de Janeiro;Área 011;18363;18252;18224;28;111;3303302005011.0
Rio de Janeiro;Área 012;23422;23303;23203;100;119;3303302005012.0
Rio de Janeiro;Área 013;24162;23972;23893;79;190;3303302005013.0
Rio de Janeiro;Área 014;30108;29827;29776;51;281;3303302005014.0
Rio de Janeiro;Área 015;78715;77719;77358;361;996;3303302005015.0
Rio de Janeiro;Área 016;18133;18057;18017;40;76;3303302005016.0
Rio de Janeiro;Área 017;53756;53407;53337;70;349;3303302005017.0
Rio de Janeiro;Área 018;17225;17064;17041;23;161;3303302005018.0
Rio de Janeiro;Nova Friburgo;182082;181516;181376;141;566;3303401.0
Rio de Janeiro;Área 001;13119;13088;13088;0;31;3303401003001.0
Rio de Janeiro;Área 002;10959;10959;10959;0;0;3303401003002.0
Rio de Janeiro;Área 003;13225;13196;13177;19;29;3303401003003.0
Rio de Janeiro;Área 004;15642;15628;15628;0;14;3303401003004.0
Rio de Janeiro;Área 005;15964;15848;15838;9;116;3303401003005.0
Rio de Janeiro;Área 006;42135;41908;41877;31;227;3303401003006.0
Rio de Janeiro;Área 007;17842;17831;17806;25;11;3303401003007.0
Rio de Janeiro;Área 008;25435;25377;25377;0;58;3303401003008.0
Rio de Janeiro;Área 009;27761;27681;27624;57;80;3303401003009.0
Rio de Janeiro;Nova Iguaçu;796257;794479;794202;277;1778;3303500.0
Rio de Janeiro;Austin;101045;101023;101023;0;22;3303500005001.0
Rio de Janeiro;Cabuãu;93108;93007;93007;0;101;3303500005004.0
Rio de Janeiro;Centro;173693;172545;172397;148;1148;3303500005002.0
Rio de Janeiro;Comendador Soares;112545;112438;112357;81;107;3303500005003.0
Rio de Janeiro;Km 32;61532;61476;61459;17;56;3303500005008.0
Rio de Janeiro;Miguel Couto;56225;56156;56156;0;69;3303500005007.0
Rio de Janeiro;Posse;117687;117459;117451;8;228;3303500005005.0
Rio de Janeiro;Tinguá-Adrianópolis-Rio do Ouro e Jaceruba;12278;12271;12271;0;7;3303500005009.0
Rio de Janeiro;Vila de Cava;68144;68103;68079;23;41;3303500005006.0
Rio de Janeiro;Paracambi;47124;47094;47081;12;30;3303609.0
Rio de Janeiro;Área 001;22798;22788;22782;7;10;3303609003001.0
Rio de Janeiro;Área 002;24326;24306;24300;6;20;3303609003002.0
Rio de Janeiro;Paraíba do Sul;41084;41057;41033;24;27;3303708.0
Rio de Janeiro;Área 001;20902;20902;20889;13;0;3303708003001.0
Rio de Janeiro;Área 002;20182;20155;20144;11;27;3303708003002.0
Rio de Janeiro;Paraty;37533;37267;37172;95;266;3303807.0
Rio de Janeiro;Área 001;20074;19883;19812;71;191;3303807003001.0
Rio de Janeiro;Área 002;17459;17384;17360;25;75;3303807003002.0
Rio de Janeiro;Petrópolis;295917;294935;294671;264;982;3303906.0
Rio de Janeiro;Área 001;16807;16571;16517;54;236;3303906005001.0
Rio de Janeiro;Área 002;15738;15738;15738;0;0;3303906005002.0
Rio de Janeiro;Área 003;17615;17571;17571;0;44;3303906005003.0
Rio de Janeiro;Área 004;14260;14212;14212;0;48;3303906005004.0
Rio de Janeiro;Área 005;19000;18938;18929;9;62;3303906005005.0
Rio de Janeiro;Área 006;22794;22767;22767;0;27;3303906005006.0
Rio de Janeiro;Área 007;22146;22076;22066;11;70;3303906005007.0
Rio de Janeiro;Área 008;23753;23687;23667;20;66;3303906005008.0
Rio de Janeiro;Área 009;14658;14592;14551;41;66;3303906005009.0
Rio de Janeiro;Área 010;19105;19063;19026;37;42;3303906005010.0
Rio de Janeiro;Cascatinha 1;22946;22863;22812;51;83;3303906005011.0
Rio de Janeiro;Cascatinha 2;19051;19020;19020;0;31;3303906005012.0
Rio de Janeiro;Cascatinha 3;22939;22826;22797;29;113;3303906005013.0
Rio de Janeiro;Itaipava;20444;20366;20354;12;78;3303906005014.0
Rio de Janeiro;Posse-Pedro do Rio;24661;24643;24643;0;18;3303906005015.0
Rio de Janeiro;Queimados;137962;137864;137804;59;98;3304144.0
Rio de Janeiro;Área 001;18014;17993;17993;0;21;3304144003001.0
Rio de Janeiro;Área 002;14633;14633;14633;0;0;3304144003002.0
Rio de Janeiro;Área 003;17407;17407;17407;0;0;3304144003003.0
Rio de Janeiro;Área 004;14729;14705;14705;0;24;3304144003004.0
Rio de Janeiro;Área 005;18139;18139;18130;9;0;3304144003005.0
Rio de Janeiro;Área 006;23305;23293;23278;15;12;3304144003006.0
Rio de Janeiro;Área 007;31735;31693;31657;36;42;3304144003007.0
Rio de Janeiro;Resende;119769;119481;119423;58;288;3304201.0
Rio de Janeiro;Área 001;16910;16910;16910;0;0;3304201003001.0
Rio de Janeiro;Área 002;13579;13572;13566;6;7;3304201003002.0
Rio de Janeiro;Área 003;12917;12822;12810;11;95;3304201003003.0
Rio de Janeiro;Área 004;20506;20391;20380;11;115;3304201003004.0
Rio de Janeiro;Área 005;21036;20995;20965;30;41;3304201003005.0
Rio de Janeiro;Área 006;34821;34791;34791;0;30;3304201003006.0
Rio de Janeiro;Rio Bonito;55551;55497;55474;23;54;3304300.0
Rio de Janeiro;Área 001;13134;13115;13102;12;19;3304300003001.0
Rio de Janeiro;Área 002;16624;16608;16597;11;16;3304300003002.0
Rio de Janeiro;Área 003;25793;25774;25774;0;19;3304300003003.0
Rio de Janeiro;Rio das Ostras;105676;105299;105191;108;377;3304524.0
Rio de Janeiro;Área 001;13049;13013;13007;6;36;3304524003001.0
Rio de Janeiro;Área 002;13287;13257;13235;22;30;3304524003002.0
Rio de Janeiro;Área 003;14259;14150;14137;13;109;3304524003003.0
Rio de Janeiro;Área 004;12834;12789;12765;25;45;3304524003004.0
Rio de Janeiro;Área 005;13113;13091;13087;4;22;3304524003005.0
Rio de Janeiro;Área 006;16857;16790;16780;11;67;3304524003006.0
Rio de Janeiro;Área 007;22277;22209;22180;28;68;3304524003007.0
Rio de Janeiro;Rio de Janeiro;6320446;6264915;6251144;13771;55531;3304557.0
Rio de Janeiro;Acari e Parque Colúmbia;36549;36518;36518;0;31;3304557005133.0
Rio de Janeiro;Anchieta 1;24947;24904;24880;24;43;3304557005128.0
Rio de Janeiro;Anchieta 2;30705;30631;30604;27;74;3304557005129.0
Rio de Janeiro;Andaraí;39365;38687;38474;213;678;3304557005066.0
Rio de Janeiro;Anil e Gardênia Azul;41887;41650;41584;66;237;3304557005143.0
Rio de Janeiro;Bangu 1;65847;65622;65601;21;225;3304557005180.0
Rio de Janeiro;Bangu 2;31950;31950;31934;16;0;3304557005181.0
Rio de Janeiro;Bangu 3;26943;26929;26929;0;14;3304557005182.0
Rio de Janeiro;Bangu 4;41980;41909;41892;18;71;3304557005183.0
Rio de Janeiro;Bangu 5;29949;29872;29827;45;77;3304557005184.0
Rio de Janeiro;Bangu 6;28150;28135;28113;22;15;3304557005185.0
Rio de Janeiro;Barra da Tijuca 1;27214;26228;26049;179;986;3304557005158.0
Rio de Janeiro;Barra da Tijuca 2;31002;30196;30045;151;806;3304557005159.0
Rio de Janeiro;Barra da Tijuca 3;23503;22711;22617;94;792;3304557005160.0
Rio de Janeiro;Barra da Tijuca 4;21904;21212;20973;240;692;3304557005161.0
Rio de Janeiro;Barra da Tijuca 5;34026;32820;32628;192;1206;3304557005162.0
Rio de Janeiro;Benfica e Mangueira;42916;42789;42588;201;127;3304557005115.0
Rio de Janeiro;Bento Ribeiro;43707;43271;43188;83;436;3304557005117.0
Rio de Janeiro;Bonsucesso;24315;24152;24152;0;163;3304557005070.0
Rio de Janeiro;Botafogo 1;21316;20961;20891;71;355;3304557005037.0
Rio de Janeiro;Botafogo 2;22520;21924;21770;153;596;3304557005038.0
Rio de Janeiro;Botafogo 3;18044;17625;17494;131;419;3304557005039.0
Rio de Janeiro;Botafogo e Urca;21409;20903;20871;32;506;3304557005035.0
Rio de Janeiro;Brás de Pina 1;29485;29227;29214;13;258;3304557005077.0
Rio de Janeiro;Brás de Pina 2;29737;29612;29568;43;125;3304557005078.0
Rio de Janeiro;Cachambi;42415;41800;41737;63;615;3304557005094.0
Rio de Janeiro;Caju, Gamboa, Santo Cristo e Saúde;48664;48349;48349;0;315;3304557005001.0
Rio de Janeiro;Campo Grande 01;27928;27904;27878;26;24;3304557005190.0
Rio de Janeiro;Campo Grande 02;39596;39528;39528;0;68;3304557005193.0
Rio de Janeiro;Campo Grande 03;37301;37199;37174;25;102;3304557005194.0
Rio de Janeiro;Campo Grande 04;29608;29589;29589;0;19;3304557005195.0
Rio de Janeiro;Campo Grande 05;28324;28189;28147;42;135;3304557005196.0
Rio de Janeiro;Campo Grande 06;26112;25910;25788;122;202;3304557005197.0
Rio de Janeiro;Campo Grande 07;25874;25817;25739;78;57;3304557005198.0
Rio de Janeiro;Campo Grande 08;24860;24716;24716;0;144;3304557005199.0
Rio de Janeiro;Campo Grande 09;35413;35352;35330;22;61;3304557005200.0
Rio de Janeiro;Campo Grande 10;25910;25875;25812;63;35;3304557005191.0
Rio de Janeiro;Campo Grande 11;27444;27420;27375;45;24;3304557005192.0
Rio de Janeiro;Cascadura;29480;29355;29331;24;125;3304557005108.0
Rio de Janeiro;Cascadura, Cavalcanti e Engenheiro Leal;27230;27047;27047;0;183;3304557005109.0
Rio de Janeiro;Catete e Glória;33718;33019;32843;176;699;3304557005030.0
Rio de Janeiro;Centro 1;19123;18839;18700;139;284;3304557005053.0
Rio de Janeiro;Centro 2;22019;21291;21202;89;728;3304557005054.0
Rio de Janeiro;Cidade de Deus;36515;36493;36473;20;22;3304557005145.0
Rio de Janeiro;Coelho Neto;32423;32332;32264;68;91;3304557005132.0
Rio de Janeiro;Colégio;29245;29129;29110;19;116;3304557005106.0
Rio de Janeiro;Complexo da Penha e Caricó;36831;36831;36818;13;0;3304557005073.0
Rio de Janeiro;Complexo do Alemão 1;27683;27683;27683;0;0;3304557005028.0
Rio de Janeiro;Complexo do Alemão 2;41460;41395;41395;0;65;3304557005029.0
Rio de Janeiro;Conjuntos Vila Kennedy, Estrada do Quafá e Estrada Sargento Miguel Filho;33473;33430;33369;61;43;3304557005179.0
Rio de Janeiro;Copacabana 1;25351;24265;24032;233;1086;3304557005041.0
Rio de Janeiro;Copacabana 2;18486;17980;17898;82;506;3304557005042.0
Rio de Janeiro;Copacabana 3;22122;21556;21281;274;566;3304557005043.0
Rio de Janeiro;Copacabana 4;25644;25255;25034;220;389;3304557005044.0
Rio de Janeiro;Copacabana 5;27373;26886;26520;366;487;3304557005045.0
Rio de Janeiro;Copacabana 6;23061;22620;22453;167;441;3304557005046.0
Rio de Janeiro;Cordovil;42091;41917;41917;0;174;3304557005080.0
Rio de Janeiro;Cosmos 1;35787;35767;35742;24;20;3304557005007.0
Rio de Janeiro;Cosmos 2;41220;41220;41220;0;0;3304557005008.0
Rio de Janeiro;Costa Barros e Barros Filho;42491;42442;42442;0;49;3304557005134.0
Rio de Janeiro;Curicica;31189;31030;30928;102;159;3304557005146.0
Rio de Janeiro;Del Castilho, Higienópolis e Maria da Graça;39316;38869;38692;177;447;3304557005083.0
Rio de Janeiro;Encantado, Abolição e Água Santa;35133;34718;34718;0;415;3304557005096.0
Rio de Janeiro;Engenho da Rainha;25776;25516;25496;20;260;3304557005085.0
Rio de Janeiro;Engenho de Dentro;45540;44981;44935;46;559;3304557005095.0
Rio de Janeiro;Engenho Novo;42172;41816;41781;35;356;3304557005089.0
Rio de Janeiro;Estácio, Catumbi e Cidade Nova;35211;34904;34877;27;307;3304557005088.0
Rio de Janeiro;Fazenda Coqueiro, Jacaré e Coréia;32033;32033;32013;20;0;3304557005186.0
Rio de Janeiro;Flamengo 1;24080;23170;23015;155;910;3304557005163.0
Rio de Janeiro;Flamengo 2;25963;25335;25007;328;628;3304557005164.0
Rio de Janeiro;Freguesia e Bancários;31949;31822;31731;91;127;3304557005120.0
Rio de Janeiro;Freguesia Jacarepaguá 1;43865;43328;43181;147;537;3304557005147.0
Rio de Janeiro;Freguesia Jacarepaguá 2;26646;26509;26340;169;137;3304557005148.0
Rio de Janeiro;Galeão;27690;27611;27611;0;79;3304557005124.0
Rio de Janeiro;Grajaú;38671;37969;37900;69;702;3304557005067.0
Rio de Janeiro;Guadalupe;47144;46950;46931;19;194;3304557005127.0
Rio de Janeiro;Guaratiba 1;29146;29082;28946;136;64;3304557005022.0
Rio de Janeiro;Guaratiba 2;38585;38542;38516;26;43;3304557005023.0
Rio de Janeiro;Guaratiba 3;27959;27899;27899;0;60;3304557005024.0
Rio de Janeiro;Guaratiba, Pedra de Guaratiba e Barra de Guaratiba;27424;27286;27274;12;138;3304557005021.0
Rio de Janeiro;Honório Gurgel;27667;27451;27380;71;216;3304557005114.0
Rio de Janeiro;Humaitá;19947;19229;19067;162;718;3304557005036.0
Rio de Janeiro;Inhaúma;45698;45314;45292;23;384;3304557005084.0
Rio de Janeiro;Inhoaíba 1;32806;32787;32787;0;19;3304557005005.0
Rio de Janeiro;Inhoaíba 2;31843;31843;31843;0;0;3304557005006.0
Rio de Janeiro;Ipanema;42743;41682;41201;481;1061;3304557005047.0
Rio de Janeiro;Irajá 1;28882;28738;28699;39;144;3304557005103.0
Rio de Janeiro;Irajá 2;26675;26397;26354;43;278;3304557005104.0
Rio de Janeiro;Irajá 3;25102;24912;24890;22;190;3304557005105.0
Rio de Janeiro;Irajá e Vista Alegre;24345;23791;23766;25;554;3304557005102.0
Rio de Janeiro;Itanhangá;41801;41573;41538;36;228;3304557005157.0
Rio de Janeiro;Jacarepaguá 1;34048;33866;33804;62;182;3304557005140.0
Rio de Janeiro;Jacarepaguá 2;30443;30280;30210;70;163;3304557005141.0
Rio de Janeiro;Jacarepaguá 3;38367;38171;38138;33;196;3304557005142.0
Rio de Janeiro;Jacarezinho;37839;37839;37839;0;0;3304557005027.0
Rio de Janeiro;Jardim América;25226;25106;24992;114;120;3304557005082.0
Rio de Janeiro;Jardim Botânico e Gávea;34012;33242;32993;249;770;3304557005051.0
Rio de Janeiro;Jardim Carioca;24848;24615;24595;20;233;3304557005122.0
Rio de Janeiro;Jardim Guanabara;32213;31451;31217;234;762;3304557005121.0
Rio de Janeiro;Jardim Sulacap, Vila Militar, Deodoro e Campo dos Afonsos;38453;38351;38327;25;102;3304557005169.0
Rio de Janeiro;Lagoa;21198;20690;20426;264;508;3304557005050.0
Rio de Janeiro;Laranjeiras;20065;19331;19078;253;734;3304557005003.0
Rio de Janeiro;Laranjeiras e Cosme Velho;32667;31877;31539;338;790;3304557005002.0
Rio de Janeiro;Leblon 1;23836;23115;22790;325;721;3304557005048.0
Rio de Janeiro;Leblon 2;22208;21788;21674;115;420;3304557005049.0
Rio de Janeiro;Leme;19154;18750;18521;229;404;3304557005040.0
Rio de Janeiro;Lins de Vasconcelos;37487;37185;37160;25;302;3304557005090.0
Rio de Janeiro;Madureira 1;24462;24295;24246;50;167;3304557005110.0
Rio de Janeiro;Madureira 2;25644;25566;25546;20;78;3304557005111.0
Rio de Janeiro;Magalhães Bastos;24430;24303;24303;0;127;3304557005170.0
Rio de Janeiro;Manguinhos;36160;36160;36160;0;0;3304557005068.0
Rio de Janeiro;Maracanã;25256;24847;24772;75;409;3304557005062.0
Rio de Janeiro;Maré 1;39260;39203;39203;0;57;3304557005031.0
Rio de Janeiro;Maré 2;29082;29041;29041;0;41;3304557005032.0
Rio de Janeiro;Maré 3;29352;29282;29256;25;70;3304557005033.0
Rio de Janeiro;Maré 4;32076;31942;31922;19;134;3304557005034.0
Rio de Janeiro;Marechal Hermes;47474;47346;47285;61;128;3304557005118.0
Rio de Janeiro;Méier 1;24152;23693;23693;0;459;3304557005091.0
Rio de Janeiro;Méier 2;25676;25255;25154;101;421;3304557005092.0
Rio de Janeiro;Olaria 1;31714;31689;31689;0;25;3304557005071.0
Rio de Janeiro;Olaria 2;25800;25194;25141;53;606;3304557005072.0
Rio de Janeiro;Oswaldo Cruz e Campinho;44196;43889;43824;65;307;3304557005116.0
Rio de Janeiro;Paciência 1;28173;28173;28173;0;0;3304557005009.0
Rio de Janeiro;Paciência 2;38419;38337;38306;30;82;3304557005010.0
Rio de Janeiro;Paciência 3;28034;28012;27996;16;22;3304557005011.0
Rio de Janeiro;Padre Miguel 1;30400;30358;30344;14;42;3304557005177.0
Rio de Janeiro;Padre Miguel 2;33828;33727;33727;0;101;3304557005178.0
Rio de Janeiro;Paquetá;3361;3323;3310;13;38;3304557005126.0
Rio de Janeiro;Parada de Lucas;27034;27034;27034;0;0;3304557005079.0
Rio de Janeiro;Parque Anchieta;26212;26170;26147;23;42;3304557005130.0
Rio de Janeiro;Pavuna 1;29372;29353;29307;45;19;3304557005135.0
Rio de Janeiro;Pavuna 2;31581;31562;31547;16;19;3304557005136.0
Rio de Janeiro;Pavuna 3;36397;36330;36308;22;67;3304557005137.0
Rio de Janeiro;Pechincha;34709;34204;34103;100;505;3304557005149.0
Rio de Janeiro;Penha;41847;41227;41166;61;620;3304557005074.0
Rio de Janeiro;Penha Circular;47816;47251;47201;49;565;3304557005075.0
Rio de Janeiro;Piedade;43378;42877;42845;31;501;3304557005097.0
Rio de Janeiro;Pilares;27250;26924;26903;21;326;3304557005098.0
Rio de Janeiro;Pitangueiras, Cacuia, Praia da Bandeira, Cocotá, Ribeira e Zumbi;39138;38810;38724;86;328;3304557005119.0
Rio de Janeiro;Portuguesa e Moneró;27169;26696;26624;72;473;3304557005125.0
Rio de Janeiro;Praça Seca 1;36410;36173;36173;0;237;3304557005154.0
Rio de Janeiro;Praça Seca 2;27737;27657;27584;73;80;3304557005155.0
Rio de Janeiro;Quintino Bocaiúva;31185;30690;30673;17;495;3304557005107.0
Rio de Janeiro;Ramos;35188;34724;34703;21;464;3304557005069.0
Rio de Janeiro;Realengo 1;27747;27710;27693;17;37;3304557005171.0
Rio de Janeiro;Realengo 2;34763;34744;34724;21;19;3304557005172.0
Rio de Janeiro;Realengo 3;24852;24731;24731;0;121;3304557005173.0
Rio de Janeiro;Realengo 4;26007;25905;25884;20;102;3304557005174.0
Rio de Janeiro;Realengo 5;25168;25041;25041;0;127;3304557005175.0
Rio de Janeiro;Realengo 6;41586;41459;41411;48;127;3304557005176.0
Rio de Janeiro;Recreio dos Bandeirantes 1;29834;29434;29362;72;400;3304557005166.0
Rio de Janeiro;Recreio dos Bandeirantes 2;27831;27300;27242;58;531;3304557005167.0
Rio de Janeiro;Recreio dos Bandeirantes 3;26726;26535;26481;54;191;3304557005168.0
Rio de Janeiro;Riachuelo, Sampaio, Rocha, Jacaré e São Francisco Xavier;49933;49283;49135;148;650;3304557005087.0
Rio de Janeiro;Ricardo de Albuquerque;29310;29197;29178;19;113;3304557005131.0
Rio de Janeiro;Rio Comprido;43764;43174;43018;156;590;3304557005076.0
Rio de Janeiro;Rio das Pedras 1;26098;26082;26082;0;16;3304557005138.0
Rio de Janeiro;Rio das Pedras 2;28370;28240;28240;0;130;3304557005139.0
Rio de Janeiro;Rocha Miranda;38510;38344;38247;97;166;3304557005113.0
Rio de Janeiro;Rocinha 1;31407;31383;31383;0;24;3304557005025.0
Rio de Janeiro;Rocinha 2;37949;37938;37927;10;11;3304557005026.0
Rio de Janeiro;Santa Cruz 1;30013;29962;29962;0;51;3304557005012.0
Rio de Janeiro;Santa Cruz 2;30335;30320;30320;0;15;3304557005013.0
Rio de Janeiro;Santa Cruz 3;36796;36796;36796;0;0;3304557005014.0
Rio de Janeiro;Santa Cruz 4;31793;31784;31784;0;9;3304557005015.0
Rio de Janeiro;Santa Cruz 5;32879;32879;32879;0;0;3304557005016.0
Rio de Janeiro;Santa Cruz 6;29569;29569;29529;40;0;3304557005017.0
Rio de Janeiro;Santa Cruz 7;25948;25930;25906;24;18;3304557005018.0
Rio de Janeiro;Santa Teresa;40926;40051;39859;192;875;3304557005144.0
Rio de Janeiro;Santíssimo;41458;41420;41407;14;38;3304557005189.0
Rio de Janeiro;São Cristóvão e Vasco da Gama;41992;41472;41439;32;520;3304557005099.0
Rio de Janeiro;Senador Camará 1;34689;34479;34461;18;210;3304557005187.0
Rio de Janeiro;Senador Camará 2;38793;38793;38793;0;0;3304557005188.0
Rio de Janeiro;Senador Vasconcelos;30600;30493;30452;40;107;3304557005004.0
Rio de Janeiro;Sepetiba 1;29170;29007;29007;0;163;3304557005019.0
Rio de Janeiro;Sepetiba 2;27405;27385;27385;0;20;3304557005020.0
Rio de Janeiro;Tanque;37856;37658;37551;107;198;3304557005153.0
Rio de Janeiro;Taquara 1;34816;34666;34578;88;150;3304557005150.0
Rio de Janeiro;Taquara 2;27886;27567;27420;147;319;3304557005151.0
Rio de Janeiro;Taquara 3;39424;38959;38927;33;465;3304557005152.0
Rio de Janeiro;Tauá;29567;29362;29343;19;205;3304557005123.0
Rio de Janeiro;Tijuca 1;24678;24450;24363;87;228;3304557005057.0
Rio de Janeiro;Tijuca 2;23244;22540;22359;180;704;3304557005058.0
Rio de Janeiro;Tijuca 3;31258;30810;30765;45;448;3304557005059.0
Rio de Janeiro;Tijuca 4;29954;29091;28972;119;863;3304557005060.0
Rio de Janeiro;Tijuca 5;21291;20946;20663;284;345;3304557005061.0
Rio de Janeiro;Tijuca e Alto da Boa Vista;23140;22723;22592;131;417;3304557005055.0
Rio de Janeiro;Tijuca e Praça da Bandeira;28245;27640;27576;64;605;3304557005056.0
Rio de Janeiro;Todos Os Santos;24646;24223;24125;98;423;3304557005093.0
Rio de Janeiro;Tomás Coelho;23559;23516;23499;17;43;3304557005086.0
Rio de Janeiro;Turiaçú e Vaz Lobo;32413;32277;32240;37;136;3304557005112.0
Rio de Janeiro;Vargem Pequena, Vargem Grande e Camorim;36982;36772;36729;43;210;3304557005165.0
Rio de Janeiro;Vicente de Carvalho e Vila Kosmos;43238;42872;42825;47;366;3304557005101.0
Rio de Janeiro;Vidigal e São Conrado;23777;23454;23454;0;323;3304557005052.0
Rio de Janeiro;Vigário Geral;41820;41698;41698;0;122;3304557005081.0
Rio de Janeiro;Vila da Penha;25465;24818;24781;38;647;3304557005100.0
Rio de Janeiro;Vila Isabel 1;28623;28550;28521;29;73;3304557005063.0
Rio de Janeiro;Vila Isabel 2;34748;34188;34015;173;560;3304557005064.0
Rio de Janeiro;Vila Isabel 3;22647;22003;21611;392;644;3304557005065.0
Rio de Janeiro;Vila Valqueire;32866;32395;32395;0;471;3304557005156.0
Rio de Janeiro;Santo Antônio de Pádua;40589;40579;40573;7;10;3304706.0
Rio de Janeiro;Área 001;20239;20239;20239;0;0;3304706003001.0
Rio de Janeiro;Área 002;20350;20340;20334;7;10;3304706003002.0
Rio de Janeiro;São Fidélis;37543;37543;37543;0;0;3304805.0
Rio de Janeiro;Área 001;18318;18318;18318;0;0;3304805003001.0
Rio de Janeiro;Área 002;19225;19225;19225;0;0;3304805003002.0
Rio de Janeiro;São Francisco de Itabapoana;41354;41311;41301;11;43;3304755.0
Rio de Janeiro;Área 001;17348;17327;17316;11;21;3304755003001.0
Rio de Janeiro;Área 002;24006;23985;23985;0;21;3304755003002.0
Rio de Janeiro;São Gonçalo;999728;998099;997385;714;1629;3304904.0
Rio de Janeiro;Ipiiba;194718;194572;194420;153;146;3304904005002.0
Rio de Janeiro;Monjolos;223058;222934;222843;91;124;3304904005003.0
Rio de Janeiro;Neves;161721;161237;161027;210;484;3304904005004.0
Rio de Janeiro;São Gonçalo;337273;336595;336372;223;678;3304904005001.0
Rio de Janeiro;Sete Pontes;82958;82761;82723;38;197;3304904005005.0
Rio de Janeiro;São João de Meriti;458673;457807;457695;113;866;3305109.0
Rio de Janeiro;Área Ponderação 02;55091;55002;55002;0;89;3305109005002.0
Rio de Janeiro;Área Ponderação 03;72289;72217;72217;0;72;3305109005003.0
Rio de Janeiro;Área Ponderação 04;101452;101194;101184;10;258;3305109005004.0
Rio de Janeiro;Área Ponderação 05;122074;121850;121779;71;224;3305109005005.0
Rio de Janeiro;Área Ponderação Principal;107767;107544;107512;32;223;3305109005001.0
Rio de Janeiro;São Pedro da Aldeia;87875;87743;87681;62;132;3305208.0
Rio de Janeiro;Área 001;14247;14183;14159;24;64;3305208003001.0
Rio de Janeiro;Área 002;20370;20335;20329;6;35;3305208003002.0
Rio de Janeiro;Área 003;25108;25087;25067;20;21;3305208003003.0
Rio de Janeiro;Área 004;28150;28138;28125;12;12;3305208003004.0
Rio de Janeiro;Saquarema;74234;73922;73818;104;312;3305505.0
Rio de Janeiro;Área 001;12769;12662;12624;38;107;3305505003001.0
Rio de Janeiro;Área 002;14296;14188;14149;39;108;3305505003002.0
Rio de Janeiro;Área 003;21983;21983;21956;27;0;3305505003003.0
Rio de Janeiro;Área 004;25186;25089;25089;0;97;3305505003004.0
Rio de Janeiro;Seropédica;78186;78005;77942;63;181;3305554.0
Rio de Janeiro;Área 001;19288;19240;19220;20;48;3305554003001.0
Rio de Janeiro;Área 002;14534;14511;14502;10;23;3305554003002.0
Rio de Janeiro;Área 003;21232;21169;21149;19;63;3305554003003.0
Rio de Janeiro;Área 004;23132;23085;23071;14;47;3305554003004.0
Rio de Janeiro;Teresópolis;163746;163009;162671;338;737;3305802.0
Rio de Janeiro;Área 001;13498;13341;13330;11;157;3305802003001.0
Rio de Janeiro;Área 002;15025;15025;15001;24;0;3305802003002.0
Rio de Janeiro;Área 003;16192;16120;16091;28;72;3305802003003.0
Rio de Janeiro;Área 004;13145;13111;13084;27;34;3305802003004.0
Rio de Janeiro;Área 005;33064;32997;32974;23;67;3305802003005.0
Rio de Janeiro;Área 006;11913;11805;11759;46;108;3305802003006.0
Rio de Janeiro;Área 007;14582;14504;14471;34;78;3305802003007.0
Rio de Janeiro;Área 008;23307;23213;23181;32;94;3305802003008.0
Rio de Janeiro;Área 009;23020;22893;22780;113;127;3305802003009.0
Rio de Janeiro;Três Rios;77432;77385;77365;20;47;3306008.0
Rio de Janeiro;Área 001;15366;15366;15356;10;0;3306008003001.0
Rio de Janeiro;Área 002;17016;17016;17016;0;0;3306008003002.0
Rio de Janeiro;Área 003;20418;20380;20380;0;38;3306008003003.0
Rio de Janeiro;Área 004;24632;24623;24613;10;9;3306008003004.0
Rio de Janeiro;Valença;71843;71730;71696;34;113;3306107.0
Rio de Janeiro;Área 001;17496;17456;17456;0;40;3306107003001.0
Rio de Janeiro;Área 002;26053;25981;25957;24;72;3306107003002.0
Rio de Janeiro;Área 003;28294;28294;28284;10;0;3306107003003.0
Rio de Janeiro;Vassouras;34410;34380;34370;10;30;3306206.0
Rio de Janeiro;Área 001;17255;17255;17245;10;0;3306206003001.0
Rio de Janeiro;Área 002;17155;17125;17125;0;30;3306206003002.0
Rio de Janeiro;Volta Redonda;257803;257444;257335;108;359;3306305.0
Rio de Janeiro;Área 001;26929;26903;26889;14;26;3306305005001.0
Rio de Janeiro;Área 002;28599;28451;28430;21;148;3306305005002.0
Rio de Janeiro;Área 003;27943;27888;27862;26;55;3306305005003.0
Rio de Janeiro;Área 004;21648;21640;21630;10;8;3306305005004.0
Rio de Janeiro;Área 005;25303;25303;25303;0;0;3306305005005.0
Rio de Janeiro;Área 006;16793;16711;16685;25;82;3306305005006.0
Rio de Janeiro;Área 007;31679;31679;31679;0;0;3306305005007.0
Rio de Janeiro;Área 008;33693;33679;33679;0;14;3306305005008.0
Rio de Janeiro;Área 009;17502;17502;17490;12;0;3306305005009.0
Rio de Janeiro;Área 010;27714;27689;27689;0;25;3306305005010.0
São Paulo;Adamantina;33797;33769;33746;24;28;3500105.0
São Paulo;Área 001;11918;11904;11892;12;14;3500105003001.0
São Paulo;Área 002;21879;21865;21853;12;14;3500105003002.0
São Paulo;Agudos;34524;34515;34500;15;9;3500709.0
São Paulo;Área 001;15695;15695;15695;0;0;3500709003001.0
São Paulo;Área 002;18829;18820;18805;15;9;3500709003002.0
São Paulo;Americana;210638;210056;209857;199;582;3501608.0
São Paulo;Centro;10567;10567;10508;59;0;3501608005001.0
São Paulo;Cidade Jardim;26927;26890;26875;15;37;3501608005010.0
São Paulo;Ipiranga-Jd São Paulo;16920;16848;16806;42;72;3501608005008.0
São Paulo;Praia Azul;13694;13672;13662;10;22;3501608005003.0
São Paulo;São Domingos-Amorim;14599;14545;14545;0;54;3501608005007.0
São Paulo;São Jeronimo;36112;36065;36054;11;47;3501608005006.0
São Paulo;São Luiz-Colina;23417;23295;23278;17;122;3501608005005.0
São Paulo;São Vito-Cordenonsi;31342;31199;31164;35;143;3501608005004.0
São Paulo;Vila Galo;11681;11637;11637;0;44;3501608005009.0
São Paulo;Zanaga;25379;25337;25328;10;42;3501608005002.0
São Paulo;Américo Brasiliense;34478;34439;34439;0;39;3501707.0
São Paulo;Área 001;15024;14999;14999;0;25;3501707003001.0
São Paulo;Área 002;19454;19440;19440;0;14;3501707003002.0
São Paulo;Amparo;65829;65717;65653;64;112;3501905.0
São Paulo;Área 001;13695;13688;13688;0;7;3501905003001.0
São Paulo;Área 002;21950;21950;21932;18;0;3501905003002.0
São Paulo;Área 003;30184;30079;30034;45;105;3501905003003.0
São Paulo;Andradina;55334;55288;55248;40;46;3502101.0
São Paulo;Área 001;12933;12920;12920;0;13;3502101003001.0
São Paulo;Área 002;16627;16617;16608;9;10;3502101003002.0
São Paulo;Área 003;25774;25751;25721;30;23;3502101003003.0
São Paulo;Aparecida;35007;34962;34920;42;45;3502507.0
São Paulo;Área 001;15350;15332;15297;34;18;3502507003001.0
São Paulo;Área 002;19657;19630;19623;8;27;3502507003002.0
São Paulo;Araçatuba;181579;181338;181104;233;241;3502804.0
São Paulo;Área 001;13996;13996;13996;0;0;3502804003001.0
São Paulo;Área 002;13039;13039;13015;24;0;3502804003002.0
São Paulo;Área 003;24180;24180;24165;15;0;3502804003003.0
São Paulo;Área 004;14297;14277;14240;37;20;3502804003004.0
São Paulo;Área 005;13924;13903;13903;0;21;3502804003005.0
São Paulo;Área 006;12671;12643;12636;6;28;3502804003006.0
São Paulo;Área 007;15729;15718;15711;7;11;3502804003007.0
São Paulo;Área 008;12880;12860;12833;27;20;3502804003008.0
São Paulo;Área 009;12684;12628;12628;0;56;3502804003009.0
São Paulo;Área 010;20267;20222;20178;44;45;3502804003010.0
São Paulo;Área 011;27912;27871;27798;73;41;3502804003011.0
São Paulo;Araraquara;208662;208346;208129;217;316;3503208.0
São Paulo;Carmo-São José;13824;13760;13752;8;64;3503208005003.0
São Paulo;Centro-São Geraldo;11377;11368;11341;26;9;3503208005004.0
São Paulo;Jardim América-Jd.Das Estações;12594;12594;12594;0;0;3503208005011.0
São Paulo;Jardim Botânico-Jardim Vale das Roseiras-Jardim Imperador;15287;15252;15238;14;35;3503208005014.0
São Paulo;Jardim Roberto Selmi Dei-Jardim São Rafael;15645;15645;15645;0;0;3503208005013.0
São Paulo;Jardim Universal-Vila Santana;12706;12676;12667;9;30;3503208005001.0
São Paulo;Núcleo Residencial Yolanda Ópice-Parque das Hortências-Jardim Del Rey;16380;16380;16374;6;0;3503208005008.0
São Paulo;Parque Gramado-Parque Residencial São Paulo;15965;15965;15965;0;0;3503208005012.0
São Paulo;Parque Residencial Iguatemi-Jardim Victório Antônio de Santi;14588;14588;14577;11;0;3503208005007.0
São Paulo;Parque Residencial Vale do Sol;12798;12798;12798;0;0;3503208005002.0
São Paulo;Rural;14756;14712;14702;10;44;3503208005015.0
São Paulo;Santa Angelina-Vila Harmonia;15214;15136;15126;10;78;3503208005005.0
São Paulo;Vila Melhado-Jardim Martinez;11975;11966;11920;45;9;3503208005006.0
São Paulo;Vila Xavier;12105;12068;12029;39;37;3503208005010.0
São Paulo;Vila Xavier-Jardim Brasil;13448;13439;13401;38;9;3503208005009.0
São Paulo;Araras;118843;118722;118704;18;121;3503307.0
São Paulo;Área 001;12632;12617;12617;0;15;3503307003001.0
São Paulo;Área 002;15654;15643;15643;0;11;3503307003002.0
São Paulo;Área 003;16974;16974;16974;0;0;3503307003003.0
São Paulo;Área 004;18774;18757;18757;0;17;3503307003004.0
São Paulo;Área 005;14159;14140;14140;0;19;3503307003005.0
São Paulo;Área 006;21091;21068;21068;0;23;3503307003006.0
São Paulo;Área 007;19559;19522;19504;18;37;3503307003007.0
São Paulo;Artur Nogueira;44177;44072;44052;20;105;3503802.0
São Paulo;Área 001;21869;21819;21809;10;50;3503802003001.0
São Paulo;Área 002;22308;22253;22243;10;55;3503802003002.0
São Paulo;Arujá;74905;74610;74544;66;295;3503901.0
São Paulo;Área 001;15502;15432;15420;12;70;3503901003001.0
São Paulo;Área 002;29545;29419;29409;10;126;3503901003002.0
São Paulo;Área 003;29858;29759;29715;44;99;3503901003003.0
São Paulo;Assis;95144;94969;94867;103;175;3504008.0
São Paulo;Área 001;14833;14807;14806;1;26;3504008003001.0
São Paulo;Área 002;29655;29655;29645;10;0;3504008003002.0
São Paulo;Área 003;24140;24068;24060;8;72;3504008003003.0
São Paulo;Área 004;26516;26440;26357;83;76;3504008003004.0
São Paulo;Atibaia;126603;125772;125491;280;831;3504107.0
São Paulo;Área 001;12576;12494;12438;57;82;3504107003001.0
São Paulo;Área 002;12445;12319;12268;52;126;3504107003002.0
São Paulo;Área 003;14348;14175;14154;21;173;3504107003003.0
São Paulo;Área 004;13547;13434;13372;62;113;3504107003004.0
São Paulo;Área 005;14424;14352;14330;22;72;3504107003005.0
São Paulo;Área 006;23853;23649;23633;15;204;3504107003006.0
São Paulo;Área 007;35410;35349;35297;52;61;3504107003007.0
São Paulo;Avaré;82934;82782;82764;18;152;3504503.0
São Paulo;Área 001;14272;14235;14228;7;37;3504503003001.0
São Paulo;Área 002;15055;15055;15055;0;0;3504503003002.0
São Paulo;Área 003;22643;22588;22588;0;55;3504503003003.0
São Paulo;Área 004;30964;30904;30893;10;60;3504503003004.0
São Paulo;Bariri;31593;31593;31593;0;0;3505203.0
São Paulo;Área 001;11919;11919;11919;0;0;3505203003001.0
São Paulo;Área 002;19674;19674;19674;0;0;3505203003002.0
São Paulo;Barra Bonita;35246;35227;35217;10;19;3505302.0
São Paulo;Área 001;11659;11659;11649;10;0;3505302003001.0
São Paulo;Área 002;23587;23568;23568;0;19;3505302003002.0
São Paulo;Barretos;112101;111880;111734;146;221;3505500.0
São Paulo;Área 001;13686;13664;13621;44;22;3505500003001.0
São Paulo;Área 002;25042;25024;25014;9;18;3505500003002.0
São Paulo;Área 003;11780;11753;11748;5;27;3505500003003.0
São Paulo;Área 004;13364;13346;13327;19;18;3505500003004.0
São Paulo;Área 005;22265;22196;22137;60;69;3505500003005.0
São Paulo;Área 006;25964;25897;25888;9;67;3505500003006.0
São Paulo;Barrinha;28496;28496;28472;24;0;3505609.0
São Paulo;Área 001;14152;14152;14152;0;0;3505609003001.0
São Paulo;Área 002;14344;14344;14320;24;0;3505609003002.0
São Paulo;Barueri;240749;239837;239525;312;912;3505708.0
São Paulo;Região Aldeia-Fazenda Militar-Votupoca;15306;15291;15291;0;15;3505708005002.0
São Paulo;Região Alphaville-Jubran-Tamboré;15156;14525;14295;231;631;3505708005012.0
São Paulo;Região Belval-Altos-Aldeia da Serra;24231;24123;24123;0;108;3505708005008.0
São Paulo;Região Califórnia;17146;17124;17124;0;22;3505708005009.0
São Paulo;Região Central do Silveira;25142;25136;25136;0;6;3505708005006.0
São Paulo;Região Centro-Boa Vista;15815;15762;15719;43;53;3505708005001.0
São Paulo;Região Cruz Preta;13776;13748;13739;9;28;3505708005011.0
São Paulo;Região Engenho Novo;20301;20289;20276;13;12;3505708005010.0
São Paulo;Região Imperial-Mutinga;30532;30532;30525;7;0;3505708005013.0
São Paulo;Região Jardim Paulista-São Fernando;15299;15299;15299;0;0;3505708005004.0
São Paulo;Região Norte do Silveira;16891;16877;16868;9;14;3505708005007.0
São Paulo;Região Parque Viana;14238;14238;14238;0;0;3505708005003.0
São Paulo;Região Sul do Silveira;16916;16892;16892;0;24;3505708005005.0
São Paulo;Batatais;56476;56446;56398;48;30;3505906.0
São Paulo;Área 001;15578;15578;15578;0;0;3505906003001.0
São Paulo;Área 002;19561;19540;19521;19;21;3505906003002.0
São Paulo;Área 003;21337;21327;21298;29;10;3505906003003.0
São Paulo;Bauru;343937;343437;342985;452;500;3506003.0
São Paulo;Centro;15347;15230;15140;90;117;3506003005001.0
São Paulo;Leste A;21575;21557;21529;29;18;3506003005002.0
São Paulo;Leste B;14449;14417;14407;10;32;3506003005003.0
São Paulo;Leste C;20070;20004;19943;62;66;3506003005004.0
São Paulo;Nordeste A;25136;25101;25070;31;35;3506003005005.0
São Paulo;Nordeste B;14690;14690;14690;0;0;3506003005006.0
São Paulo;Noroeste A;24593;24571;24547;24;22;3506003005007.0
São Paulo;Noroeste B;18148;18148;18136;12;0;3506003005008.0
São Paulo;Noroeste C;28926;28906;28906;0;20;3506003005009.0
São Paulo;Norte A;26484;26449;26433;17;35;3506003005010.0
São Paulo;Norte B;18677;18667;18635;32;10;3506003005011.0
São Paulo;Norte C;21663;21649;21622;27;14;3506003005012.0
São Paulo;Oeste A;22451;22442;22424;18;9;3506003005013.0
São Paulo;Oeste B;15624;15594;15561;32;30;3506003005014.0
São Paulo;Sudeste A;24030;24019;24019;0;11;3506003005015.0
São Paulo;Sudoeste;13180;13180;13164;16;0;3506003005016.0
São Paulo;Sul;18894;18812;18760;52;82;3506003005017.0
São Paulo;Bebedouro;75035;74929;74833;96;106;3506102.0
São Paulo;Área 001;13302;13275;13275;0;27;3506102003001.0
São Paulo;Área 002;11528;11471;11451;20;57;3506102003002.0
São Paulo;Área 003;25689;25678;25648;30;11;3506102003003.0
São Paulo;Área 004;24516;24505;24459;46;11;3506102003004.0
São Paulo;Bertioga;47645;47484;47441;44;161;3506359.0
São Paulo;Área 001;22551;22444;22428;17;107;3506359003001.0
São Paulo;Área 002;25094;25040;25013;27;54;3506359003002.0
São Paulo;Birigui;108728;108611;108477;134;117;3506508.0
São Paulo;Área 001;14697;14697;14697;0;0;3506508003001.0
São Paulo;Área 002;18813;18813;18781;32;0;3506508003002.0
São Paulo;Área 003;14917;14917;14910;7;0;3506508003003.0
São Paulo;Área 004;12306;12266;12240;26;40;3506508003004.0
São Paulo;Área 005;22581;22513;22473;40;68;3506508003005.0
São Paulo;Área 006;25414;25406;25377;29;8;3506508003006.0
São Paulo;Boituva;48314;48145;48105;40;169;3507001.0
São Paulo;Área 001;20501;20450;20439;11;51;3507001003001.0
São Paulo;Área 002;27813;27696;27666;29;117;3507001003002.0
São Paulo;Botucatu;127328;127134;127024;110;194;3507506.0
São Paulo;Área 001;11426;11387;11361;26;39;3507506003001.0
São Paulo;Área 002;14991;14928;14915;12;63;3507506003002.0
São Paulo;Área 003;17199;17199;17191;8;0;3507506003003.0
São Paulo;Área 004;18514;18514;18514;0;0;3507506003004.0
São Paulo;Área 005;13605;13592;13570;22;13;3507506003005.0
São Paulo;Área 006;24543;24506;24485;20;37;3507506003006.0
São Paulo;Área 007;27050;27009;26988;21;41;3507506003007.0
São Paulo;Bragança Paulista;146744;146147;145879;268;597;3507605.0
São Paulo;Área 001;14818;14779;14764;15;39;3507605003001.0
São Paulo;Área 002;13578;13422;13352;71;156;3507605003002.0
São Paulo;Área 003;14593;14432;14380;52;161;3507605003003.0
São Paulo;Área 004;15939;15876;15851;25;63;3507605003004.0
São Paulo;Área 005;13355;13325;13316;9;30;3507605003005.0
São Paulo;Área 006;13842;13810;13810;0;32;3507605003006.0
São Paulo;Área 007;15546;15517;15517;0;29;3507605003007.0
São Paulo;Área 008;20783;20730;20718;11;53;3507605003008.0
São Paulo;Área 009;24290;24256;24170;86;34;3507605003009.0
São Paulo;Cabreúva;41604;41513;41488;26;91;3508405.0
São Paulo;Área 001;16026;15976;15976;0;50;3508405003001.0
São Paulo;Área 002;25578;25537;25512;26;41;3508405003002.0
São Paulo;Caçapava;84752;84599;84540;59;153;3508504.0
São Paulo;Área 001;18194;18165;18156;9;29;3508504003001.0
São Paulo;Área 002;17057;16998;16979;19;59;3508504003002.0
São Paulo;Área 003;19948;19915;19907;9;33;3508504003003.0
São Paulo;Área 004;29553;29521;29499;22;32;3508504003004.0
São Paulo;Caieiras;86529;86348;86262;86;181;3509007.0
São Paulo;Área 001;16056;16056;16056;0;0;3509007003001.0
São Paulo;Área 002;18844;18804;18804;0;40;3509007003002.0
São Paulo;Área 003;25124;24993;24963;31;131;3509007003003.0
São Paulo;Área 004;26505;26495;26440;55;10;3509007003004.0
São Paulo;Cajamar;64114;63985;63933;53;129;3509205.0
São Paulo;Área 001;18418;18347;18311;36;71;3509205003001.0
São Paulo;Área 002;21626;21618;21601;17;8;3509205003002.0
São Paulo;Área 003;24070;24020;24020;0;50;3509205003003.0
São Paulo;Campinas;1080113;1075724;1073865;1859;4389;3509502.0
São Paulo;Årea Urbana de Sousas;19462;19279;19257;22;183;3509502005002.0
São Paulo;Barão Geraldo-Real Parque-Guará;25906;25605;25531;74;301;3509502005003.0
São Paulo;Cambuí;23808;23506;23396;110;302;3509502005012.0
São Paulo;Centro;18187;17936;17901;35;251;3509502005013.0
São Paulo;Eixo Campinas-Mogi Mirim-Universidades;33059;32604;32444;160;455;3509502005004.0
São Paulo;Núcleo Urbano de Joaquim Egídio e Zona Rural Apa;5611;5583;5571;12;28;3509502005001.0
São Paulo;Região Boa Vista-Via Norte-Santa Bárbara;27896;27896;27867;29;0;3509502005035.0
São Paulo;Região Bonfim-Proost de Sousa;26539;26438;26404;34;101;3509502005007.0
São Paulo;Região Bosque-Proença;37454;37207;37083;123;247;3509502005014.0
São Paulo;Região Campo Belo-Jd Fernanda-Viracopos;32006;31988;31988;0;18;3509502005032.0
São Paulo;Região Campo Grande-Parque Valença;33860;33860;33860;0;0;3509502005025.0
São Paulo;Região Campos Elíseos-Ipaussurama;29602;29555;29555;0;47;3509502005015.0
São Paulo;Região Chapadão-Vila Nova;31186;30854;30702;152;332;3509502005005.0
São Paulo;Região Costa e Silva-Mansões de Santo Antônio;30406;30182;30076;106;224;3509502005006.0
São Paulo;Região Dics-Cohab;33898;33881;33881;0;17;3509502005031.0
São Paulo;Região Florence-Satélite Irís;31114;31114;31114;0;0;3509502005027.0
São Paulo;Região Guanabara-Jd Ns Auxiliadora-Lagoa do Taquaral;26255;25921;25867;54;334;3509502005010.0
São Paulo;Região Jardim do Lago-Itatinga;29245;29121;29121;0;124;3509502005019.0
São Paulo;Região Jd Garcia-Jd Aurélia;25457;25436;25436;0;21;3509502005016.0
São Paulo;Região Jd Planalto-Distrito Industrial;29585;29585;29510;75;0;3509502005030.0
São Paulo;Região Jd Santa Lúcia-Novos Campos Elíseos;33769;33757;33736;22;12;3509502005017.0
São Paulo;Região Mauro Marcondes-Vida Nova-Friburgo;31378;31360;31023;337;18;3509502005029.0
São Paulo;Região Nova Aparecida;29601;29601;29601;0;0;3509502005034.0
São Paulo;Região Nova Europa-Jambeiro;29653;29553;29533;20;100;3509502005022.0
São Paulo;Região Ouro Verde;34005;34005;34005;0;0;3509502005028.0
São Paulo;Região Oziel-Bandeiras;31597;31597;31492;105;0;3509502005024.0
São Paulo;Região Parque Brasília-Flamboyant-Chácara da Barra;27085;26834;26765;69;251;3509502005009.0
São Paulo;Região Santa Odila-Jd das Oliveiras-Carlos Lourenço;50449;50321;50279;42;128;3509502005023.0
São Paulo;Região São Domingo-Nova América-San Diego;31851;31851;31851;0;0;3509502005033.0
São Paulo;Região São Fernando;33859;33859;33859;0;0;3509502005021.0
São Paulo;Região São Luiz-Itajaí-Lisa;35303;35303;35303;0;0;3509502005026.0
São Paulo;Região São Marcos-San Martin;36667;36638;36638;0;29;3509502005036.0
São Paulo;Região São Quirino-Primavera-Parque Taquaral;28282;27989;27896;93;293;3509502005008.0
São Paulo;Região Vila Brandina-Gramado;27072;26677;26552;125;395;3509502005011.0
São Paulo;Região Vila Teixeira-Pq Industrial-São Bernardo;37522;37366;37323;42;156;3509502005020.0
São Paulo;Região Vila União-Jd Capivari;31484;31463;31444;18;21;3509502005018.0
São Paulo;Campo Limpo Paulista;74074;73873;73788;86;201;3509601.0
São Paulo;Área 001;14078;14068;14068;0;10;3509601003001.0
São Paulo;Área 002;13463;13395;13365;31;68;3509601003002.0
São Paulo;Área 003;20409;20286;20238;48;123;3509601003003.0
São Paulo;Área 004;26124;26124;26117;7;0;3509601003004.0
São Paulo;Campos do Jordão;47789;47653;47632;21;136;3509700.0
São Paulo;Área 001;22827;22796;22786;10;31;3509700003001.0
São Paulo;Área 002;24962;24857;24846;11;105;3509700003002.0
São Paulo;Capão Bonito;46178;46140;46069;71;38;3510203.0
São Paulo;Área 001;22729;22720;22720;0;9;3510203003001.0
São Paulo;Área 002;23449;23420;23349;71;29;3510203003002.0
São Paulo;Capivari;48576;48532;48486;46;44;3510401.0
São Paulo;Área 001;20205;20205;20168;37;0;3510401003001.0
São Paulo;Área 002;28371;28327;28318;9;44;3510401003002.0
São Paulo;Caraguatatuba;100840;100373;100186;187;467;3510500.0
São Paulo;Área 001;12696;12606;12606;0;90;3510500003001.0
São Paulo;Área 002;12049;11944;11848;96;105;3510500003002.0
São Paulo;Área 003;15919;15864;15801;62;55;3510500003003.0
São Paulo;Área 004;14317;14307;14298;9;10;3510500003004.0
São Paulo;Área 005;20094;20013;20003;10;81;3510500003005.0
São Paulo;Área 006;25765;25638;25629;10;127;3510500003006.0
São Paulo;Carapicuíba;369584;368853;368603;249;731;3510609.0
São Paulo;Centro;28100;27968;27956;11;132;3510609005001.0
São Paulo;Cohab;45871;45862;45862;0;9;3510609005002.0
São Paulo;Corintinha-Vila Cretti-Vila Menck;63859;63719;63683;36;140;3510609005004.0
São Paulo;Jardim Tonato-Angelica-Fazendinha-São Camilo-Aldeia;74999;74836;74702;134;163;3510609005006.0
São Paulo;Parque Jandaia-Parque Industrial-Vila Dirce-Ana Estela-Planalto;52028;51912;51891;21;116;3510609005007.0
São Paulo;Vila Lourdes-Ariston;44493;44433;44433;0;60;3510609005003.0
São Paulo;Vila Marcondes-Capriotti-Roseira;60234;60123;60077;47;111;3510609005005.0
São Paulo;Casa Branca;28307;28237;28237;0;70;3510807.0
São Paulo;Área 001;13100;13060;13060;0;40;3510807003001.0
São Paulo;Área 002;15207;15176;15176;0;31;3510807003002.0
São Paulo;Catanduva;112820;112771;112721;50;49;3511102.0
São Paulo;Área 001;16899;16899;16887;12;0;3511102003001.0
São Paulo;Área 002;13563;13544;13544;0;19;3511102003002.0
São Paulo;Área 003;13847;13847;13847;0;0;3511102003003.0
São Paulo;Área 004;13140;13120;13115;5;20;3511102003004.0
São Paulo;Área 005;14667;14656;14656;0;11;3511102003005.0
São Paulo;Área 006;19242;19242;19209;33;0;3511102003006.0
São Paulo;Área 007;21462;21462;21462;0;0;3511102003007.0
São Paulo;Cerquilho;39617;39575;39539;35;42;3511508.0
São Paulo;Área 001;15083;15071;15071;0;12;3511508003001.0
São Paulo;Área 002;24534;24504;24468;35;30;3511508003002.0
São Paulo;Cosmópolis;58827;58801;58751;49;26;3512803.0
São Paulo;Área 001;13748;13748;13730;18;0;3512803003001.0
São Paulo;Área 002;18907;18900;18879;21;7;3512803003002.0
São Paulo;Área 003;26172;26152;26142;10;20;3512803003003.0
São Paulo;Cotia;201150;199966;199585;381;1184;3513009.0
São Paulo;Área 001;14083;13925;13875;50;158;3513009003001.0
São Paulo;Área 002;15822;15474;15322;152;348;3513009003002.0
São Paulo;Área 003;17649;17563;17513;50;86;3513009003003.0
São Paulo;Área 004;18839;18831;18831;0;8;3513009003004.0
São Paulo;Área 005;16945;16945;16908;37;0;3513009003005.0
São Paulo;Área 006;28429;28367;28334;33;62;3513009003006.0
São Paulo;Área 007;18716;18573;18538;35;143;3513009003007.0
São Paulo;Área 008;21104;21008;20994;13;96;3513009003008.0
São Paulo;Área 009;17716;17600;17600;0;116;3513009003009.0
São Paulo;Área 010;31847;31680;31669;11;167;3513009003010.0
São Paulo;Cravinhos;31691;31679;31679;0;12;3513108.0
São Paulo;Área 001;13753;13741;13741;0;12;3513108003001.0
São Paulo;Área 002;17938;17938;17938;0;0;3513108003002.0
São Paulo;Cruzeiro;77039;76959;76878;81;80;3513405.0
São Paulo;Área 001;13873;13833;13794;39;40;3513405003001.0
São Paulo;Área 002;14220;14220;14220;0;0;3513405003002.0
São Paulo;Área 003;19266;19236;19195;41;30;3513405003003.0
São Paulo;Área 004;29680;29669;29669;0;11;3513405003004.0
São Paulo;Cubatão;118720;118537;118468;69;183;3513504.0
São Paulo;Área 001;13548;13494;13481;12;54;3513504003001.0
São Paulo;Área 002;39143;39072;39024;48;71;3513504003002.0
São Paulo;Área 003;14612;14612;14612;0;0;3513504003003.0
São Paulo;Área 004;25143;25085;25076;9;58;3513504003004.0
São Paulo;Área 005;26274;26274;26274;0;0;3513504003005.0
São Paulo;Descalvado;31056;31036;31036;0;20;3513702.0
São Paulo;Área 001;15361;15361;15361;0;0;3513702003001.0
São Paulo;Área 002;15695;15675;15675;0;20;3513702003002.0
São Paulo;Diadema;386089;385274;384957;317;815;3513801.0
São Paulo;Campanário Norte;17449;17449;17449;0;0;3513801005001.0
São Paulo;Campanário Sul;14826;14802;14802;0;24;3513801005002.0
São Paulo;Canhema;23550;23523;23509;14;27;3513801005003.0
São Paulo;Casa Grande Norte;17741;17732;17732;0;9;3513801005004.0
São Paulo;Casa Grande Sul;20477;20467;20456;11;10;3513801005005.0
São Paulo;Centro Leste;13587;13452;13383;69;135;3513801005006.0
São Paulo;Centro Norte;14030;13902;13886;16;128;3513801005007.0
São Paulo;Centro Oeste;16830;16740;16675;65;90;3513801005008.0
São Paulo;Conceição Leste;13959;13949;13949;0;10;3513801005009.0
São Paulo;Conceição Oeste;16134;16084;16067;17;50;3513801005010.0
São Paulo;Conceição Sudoeste;16165;16165;16165;0;0;3513801005011.0
São Paulo;Eldorado Norte;25649;25623;25607;15;26;3513801005012.0
São Paulo;Eldorado Sul-Oeste;16988;16979;16979;0;9;3513801005013.0
São Paulo;Inamar;21459;21450;21450;0;9;3513801005014.0
São Paulo;Paineiras;18795;18726;18687;39;69;3513801005015.0
São Paulo;Piraporinha;26088;25979;25958;21;109;3513801005016.0
São Paulo;Serraria Leste;15081;15081;15081;0;0;3513801005017.0
São Paulo;Serraria Oeste;16159;16159;16159;0;0;3513801005018.0
São Paulo;Taboão Norte;14342;14307;14307;0;35;3513801005019.0
São Paulo;Taboão Sul;15639;15599;15599;0;40;3513801005020.0
São Paulo;Vila Nogueira Norte;14017;13981;13969;12;36;3513801005021.0
São Paulo;Vila Nogueira Sul;17124;17124;17087;37;0;3513801005022.0
São Paulo;Dracena;43258;43182;43100;82;76;3514403.0
São Paulo;Área 001;20936;20892;20871;20;44;3514403003001.0
São Paulo;Área 002;22322;22290;22229;61;32;3514403003002.0
São Paulo;Embu das Artes;240230;239773;239606;167;457;3515004.0
São Paulo;Ângela-Batista;15906;15906;15889;17;0;3515004005001.0
São Paulo;Castilho-Fatima;23478;23478;23478;0;0;3515004005008.0
São Paulo;Centro-Engenho Velho;17435;17370;17359;11;65;3515004005010.0
São Paulo;Colégio-São Marcos;26996;26976;26968;8;20;3515004005005.0
São Paulo;Dom José-Santo Eduardo;17827;17773;17735;37;54;3515004005002.0
São Paulo;Eixo Br116;25699;25651;25598;53;48;3515004005011.0
São Paulo;Independência-Casa Branca;19443;19443;19443;0;0;3515004005004.0
São Paulo;Pinheirinho-Santa Clara;15343;15343;15317;26;0;3515004005009.0
São Paulo;Região Oeste;15112;14871;14857;14;241;3515004005012.0
São Paulo;Santa Emília;16912;16892;16892;0;20;3515004005003.0
São Paulo;Santa Tereza;19694;19694;19694;0;0;3515004005007.0
São Paulo;Vazame-Pirajussara;26385;26377;26377;0;8;3515004005006.0
São Paulo;Embu-Guaçu;62769;62457;62390;67;312;3515103.0
São Paulo;Área 001;15697;15639;15627;12;58;3515103003001.0
São Paulo;Área 002;23001;22805;22791;14;196;3515103003002.0
São Paulo;Área 003;24071;24013;23972;41;58;3515103003003.0
São Paulo;Espírito Santo do Pinhal;41907;41888;41888;0;19;3515186.0
São Paulo;Área 001;19157;19147;19147;0;10;3515186003001.0
São Paulo;Área 002;22750;22741;22741;0;9;3515186003002.0
São Paulo;Fernandópolis;64696;64639;64589;50;57;3515509.0
São Paulo;Área 001;13105;13105;13086;19;0;3515509003001.0
São Paulo;Área 002;12331;12314;12314;0;17;3515509003002.0
São Paulo;Área 003;18265;18225;18204;21;40;3515509003003.0
São Paulo;Área 004;20995;20995;20985;10;0;3515509003004.0
São Paulo;Ferraz de Vasconcelos;168306;168021;167903;118;285;3515707.0
São Paulo;Área 001;14352;14352;14345;7;0;3515707003001.0
São Paulo;Área 002;18487;18474;18474;0;13;3515707003002.0
São Paulo;Área 003;18818;18776;18776;0;42;3515707003003.0
São Paulo;Área 004;14751;14751;14751;0;0;3515707003004.0
São Paulo;Área 005;16635;16626;16626;0;9;3515707003005.0
São Paulo;Área 006;16270;16270;16270;0;0;3515707003006.0
São Paulo;Área 007;32733;32712;32712;0;21;3515707003007.0
São Paulo;Área 008;36260;36059;35948;111;201;3515707003008.0
São Paulo;Franca;318640;318347;318183;164;293;3516200.0
São Paulo;01-Sul;16634;16634;16634;0;0;3516200005001.0
São Paulo;02-Sul;14242;14242;14242;0;0;3516200005002.0
São Paulo;03-Sudeste;15251;15251;15228;23;0;3516200005003.0
São Paulo;04-Centro Sul;14961;14897;14848;49;64;3516200005004.0
São Paulo;05-Centro Leste;14550;14550;14527;23;0;3516200005005.0
São Paulo;06-Leste;17938;17938;17938;0;0;3516200005006.0
São Paulo;07-Leste Brasilândia;14109;14097;14097;0;12;3516200005007.0
São Paulo;08-Centro Leste São José;12618;12604;12604;0;14;3516200005008.0
São Paulo;09-Nordeste;15775;15775;15775;0;0;3516200005009.0
São Paulo;10-Leste Aparecida;14129;14129;14129;0;0;3516200005010.0
São Paulo;11-Norte;18817;18791;18781;11;26;3516200005011.0
São Paulo;12-Norte Leporace;14878;14865;14865;0;13;3516200005012.0
São Paulo;13-Noroeste;13627;13627;13618;9;0;3516200005013.0
São Paulo;14-Norte Santa Terezinha;15313;15313;15304;9;0;3516200005014.0
São Paulo;15-Centro Nordeste;13766;13749;13749;0;17;3516200005015.0
São Paulo;16-Centro Norte;16418;16406;16406;0;12;3516200005016.0
São Paulo;17-Oeste;15038;15038;15038;0;0;3516200005017.0
São Paulo;18-Oeste Distrito;17462;17449;17449;0;13;3516200005018.0
São Paulo;19-Oeste Vila Tião;17490;17438;17429;9;52;3516200005019.0
São Paulo;20-Centro;12938;12919;12907;12;19;3516200005020.0
São Paulo;21-Amazonas;12686;12634;12614;20;52;3516200005021.0
São Paulo;Francisco Morato;154472;154268;154193;75;204;3516309.0
São Paulo;Área 001;13639;13627;13615;12;12;3516309003001.0
São Paulo;Área 002;41072;40997;40978;18;75;3516309003002.0
São Paulo;Área 003;35672;35653;35627;25;19;3516309003003.0
São Paulo;Área 004;22227;22170;22161;9;57;3516309003004.0
São Paulo;Área 005;41862;41822;41812;10;40;3516309003005.0
São Paulo;Franco da Rocha;131604;131399;131355;44;205;3516408.0
São Paulo;Área 001;14537;14526;14526;0;11;3516408003001.0
São Paulo;Área 002;15941;15897;15897;0;44;3516408003002.0
São Paulo;Área 003;15025;15005;15005;0;20;3516408003003.0
São Paulo;Área 004;20362;20327;20327;0;35;3516408003004.0
São Paulo;Área 005;29506;29438;29430;8;68;3516408003005.0
São Paulo;Área 006;36233;36205;36169;36;28;3516408003006.0
São Paulo;Garça;43115;42999;42943;56;116;3516705.0
São Paulo;Área 001;21317;21260;21249;11;57;3516705003001.0
São Paulo;Área 002;21798;21739;21694;45;59;3516705003002.0
São Paulo;Guaíra;37404;37381;37381;0;23;3517406.0
São Paulo;Área 001;16169;16155;16155;0;14;3517406003001.0
São Paulo;Área 002;21235;21226;21226;0;9;3517406003002.0
São Paulo;Guararapes;30597;30542;30520;22;55;3518206.0
São Paulo;Área 001;13302;13254;13232;22;48;3518206003001.0
São Paulo;Área 002;17295;17288;17288;0;7;3518206003002.0
São Paulo;Guaratinguetá;112072;111804;111756;48;268;3518404.0
São Paulo;Área 001;16892;16870;16870;0;22;3518404003001.0
São Paulo;Área 002;33953;33781;33746;35;172;3518404003002.0
São Paulo;Área 003;30062;30039;30039;0;23;3518404003003.0
São Paulo;Área 004;31165;31114;31100;13;51;3518404003004.0
São Paulo;Guariba;35486;35486;35469;17;0;3518602.0
São Paulo;Área 001;13939;13939;13939;0;0;3518602003001.0
São Paulo;Área 002;21547;21547;21530;17;0;3518602003002.0
São Paulo;Guarujá;290752;289544;289194;351;1208;3518701.0
São Paulo;Área 001;14847;14433;14276;157;414;3518701005001.0
São Paulo;Área 002;19055;18990;18954;36;65;3518701005002.0
São Paulo;Área 003;17575;17563;17563;0;12;3518701005003.0
São Paulo;Área 004;18868;18645;18618;28;223;3518701005004.0
São Paulo;Área 005;21734;21694;21694;0;40;3518701005005.0
São Paulo;Área 006;17130;17097;17097;0;33;3518701005006.0
São Paulo;Área 007;29600;29426;29344;82;174;3518701005007.0
São Paulo;Área 008;18251;18183;18183;0;68;3518701005008.0
São Paulo;Área 009;14812;14786;14771;15;26;3518701005009.0
São Paulo;Área 010;26054;25984;25974;10;70;3518701005010.0
São Paulo;Área 011;17437;17421;17421;0;16;3518701005011.0
São Paulo;Área 012;18333;18301;18279;22;32;3518701005012.0
São Paulo;Área 013;15744;15732;15732;0;12;3518701005013.0
São Paulo;Área 014;20209;20197;20197;0;12;3518701005014.0
São Paulo;Área 015;21103;21092;21092;0;11;3518701005015.0
São Paulo;Guarulhos;1221979;1216222;1214925;1297;5757;3518800.0
São Paulo;Água Chata;57136;56838;56727;111;298;3518800005019.0
São Paulo;Área de Proteção Ambiental I;31010;31010;30980;30;0;3518800005026.0
São Paulo;Área de Proteção Ambiental II;29359;29343;29312;31;16;3518800005030.0
São Paulo;Bananal;47396;47360;47360;0;36;3518800005016.0
São Paulo;Bela Vista;28797;28693;28688;5;104;3518800005013.0
São Paulo;Bom Clima;28965;28781;28693;88;184;3518800005004.0
São Paulo;Bonsucesso;34743;34310;34289;21;433;3518800005029.0
São Paulo;Cecap;29966;29730;29613;116;236;3518800005002.0
São Paulo;Centro Expandido;44867;44282;44090;192;585;3518800005001.0
São Paulo;Cid. Jd. Cumbica;36922;36873;36873;0;49;3518800005022.0
São Paulo;Cidade Seródio;34884;34754;34717;38;130;3518800005014.0
São Paulo;Ciscumbica;34058;34058;34010;48;0;3518800005024.0
São Paulo;Cocaia;39149;39012;39012;0;137;3518800005005.0
São Paulo;Continental;43589;43501;43490;10;88;3518800005008.0
São Paulo;Cumbica;47874;47580;47555;25;294;3518800005023.0
São Paulo;Gopouva;40954;40752;40659;93;202;3518800005010.0
São Paulo;Itaim;34021;33214;33202;12;807;3518800005018.0
São Paulo;Morros;42944;42872;42872;0;72;3518800005017.0
São Paulo;Picanço;40848;40649;40611;37;199;3518800005007.0
São Paulo;Pimentas I;46205;46024;46024;0;181;3518800005021.0
São Paulo;Pimentas II;56827;56620;56566;53;207;3518800005025.0
São Paulo;Ponte Alta;35076;35053;35053;0;23;3518800005028.0
São Paulo;Ponte Grande Itapegica;39218;39179;39132;47;39;3518800005012.0
São Paulo;Pres. Dutra;57955;57751;57702;49;204;3518800005027.0
São Paulo;São João;48813;48699;48679;20;114;3518800005015.0
São Paulo;Taboão;59431;59263;59216;47;168;3518800005020.0
São Paulo;Vila Augusta;37332;37069;37027;42;263;3518800005011.0
São Paulo;Vila Barros;36409;36134;36096;38;275;3518800005003.0
São Paulo;Vila Galvão;48498;48125;47981;144;373;3518800005009.0
São Paulo;Vila Rio;28733;28694;28694;0;39;3518800005006.0
São Paulo;Hortolândia;192692;192329;192225;105;363;3519071.0
São Paulo;Área 001;16902;16768;16741;27;134;3519071005001.0
São Paulo;Área 002;14704;14677;14658;19;27;3519071005002.0
São Paulo;Área 003;14927;14896;14856;40;31;3519071005003.0
São Paulo;Área 004;35244;35219;35219;0;25;3519071005004.0
São Paulo;Área 005;20471;20471;20465;6;0;3519071005005.0
São Paulo;Área 006;25004;25004;25004;0;0;3519071005006.0
São Paulo;Área 007;23976;23922;23915;7;54;3519071005007.0
São Paulo;Área 008;19194;19161;19161;0;33;3519071005008.0
São Paulo;Área 009;22270;22212;22206;6;58;3519071005009.0
São Paulo;Ibitinga;53158;53150;53117;33;8;3519600.0
São Paulo;Área 001;23391;23391;23375;16;0;3519600003001.0
São Paulo;Área 002;29767;29759;29742;17;8;3519600003002.0
São Paulo;Ibiúna;71217;70765;70571;194;452;3519709.0
São Paulo;Área 001;18624;18466;18427;39;158;3519709003001.0
São Paulo;Área 002;23898;23800;23740;60;98;3519709003002.0
São Paulo;Área 003;28695;28498;28403;95;197;3519709003003.0
São Paulo;Indaiatuba;201619;201022;200857;164;597;3520509.0
São Paulo;Outras Zonas;129355;128834;128700;134;521;3520509005003.0
São Paulo;Zona Sul Direita;18662;18637;18618;19;25;3520509005002.0
São Paulo;Zona Sul Esquerda;53602;53551;53540;12;51;3520509005001.0
São Paulo;Itanhaém;87057;86584;86483;101;473;3522109.0
São Paulo;Área 001;13484;13475;13465;11;9;3522109003001.0
São Paulo;Área 002;13261;13040;13014;25;221;3522109003002.0
São Paulo;Área 003;13608;13566;13557;10;42;3522109003003.0
São Paulo;Área 004;21248;21204;21180;25;44;3522109003004.0
São Paulo;Área 005;25456;25297;25267;30;159;3522109003005.0
São Paulo;Itapecerica da Serra;152614;152261;152091;170;353;3522208.0
São Paulo;Área 001;14363;14305;14279;26;58;3522208003001.0
São Paulo;Área 002;15685;15685;15672;13;0;3522208003002.0
São Paulo;Área 003;17928;17885;17885;0;43;3522208003003.0
São Paulo;Área 004;22504;22475;22446;29;29;3522208003004.0
São Paulo;Área 005;22461;22440;22417;23;21;3522208003005.0
São Paulo;Área 006;28461;28378;28367;11;83;3522208003006.0
São Paulo;Área 007;31212;31092;31026;67;120;3522208003007.0
São Paulo;Itapetininga;144377;144136;144041;95;241;3522307.0
São Paulo;Área 001;13028;12938;12915;23;90;3522307003001.0
São Paulo;Área 002;32015;31968;31940;28;47;3522307003002.0
São Paulo;Área 003;16603;16592;16592;0;11;3522307003003.0
São Paulo;Área 004;15606;15606;15595;11;0;3522307003004.0
São Paulo;Área 005;21563;21529;21529;0;34;3522307003005.0
São Paulo;Área 006;20768;20758;20758;0;10;3522307003006.0
São Paulo;Área 007;24794;24745;24712;33;49;3522307003007.0
São Paulo;Itapeva;87753;87667;87615;52;86;3522406.0
São Paulo;Área 001;14254;14241;14229;12;13;3522406003001.0
São Paulo;Área 002;13131;13117;13117;0;14;3522406003002.0
São Paulo;Área 003;13545;13514;13514;0;31;3522406003003.0
São Paulo;Área 004;22937;22937;22937;0;0;3522406003004.0
São Paulo;Área 005;23886;23858;23818;40;28;3522406003005.0
São Paulo;Itapevi;200769;200557;200456;101;212;3522505.0
São Paulo;Centro;14664;14651;14615;36;13;3522505005001.0
São Paulo;Cohab I;13252;13206;13199;7;46;3522505005005.0
São Paulo;Cohab II;15615;15601;15589;13;14;3522505005006.0
São Paulo;Jd Amador Bueno;15800;15800;15794;6;0;3522505005013.0
São Paulo;Jd Bela Vista;16153;16143;16143;0;10;3522505005007.0
São Paulo;Jd Maria Cecília;14620;14620;14620;0;0;3522505005008.0
São Paulo;Jd Marina;16009;15961;15940;21;48;3522505005011.0
São Paulo;Jd Nova Itapevi;15963;15933;15933;0;30;3522505005012.0
São Paulo;Jd Portela;14715;14685;14667;18;30;3522505005002.0
São Paulo;Jd Rosemary;16229;16229;16229;0;0;3522505005003.0
São Paulo;Jd Santa Rita;14978;14967;14967;0;11;3522505005010.0
São Paulo;Jd Vitápolis;14603;14592;14592;0;11;3522505005009.0
São Paulo;Pq. Suburbano;18168;18168;18168;0;0;3522505005004.0
São Paulo;Itapira;68537;68529;68529;0;8;3522604.0
São Paulo;Área 001;17244;17244;17244;0;0;3522604003001.0
São Paulo;Área 002;19439;19439;19439;0;0;3522604003002.0
São Paulo;Área 003;31854;31846;31846;0;8;3522604003003.0
São Paulo;Itápolis;40051;40034;40023;11;17;3522703.0
São Paulo;Área 001;18859;18850;18850;0;9;3522703003001.0
São Paulo;Área 002;21192;21184;21173;11;8;3522703003002.0
São Paulo;Itaquaquecetuba;321770;321071;320914;157;699;3523107.0
São Paulo;Aracaré;26580;26521;26521;0;59;3523107005004.0
São Paulo;Campo Limpo I;21627;21606;21592;15;21;3523107005013.0
São Paulo;Campo Limpo II;23538;23511;23511;0;27;3523107005014.0
São Paulo;Centro;25527;25497;25485;12;30;3523107005006.0
São Paulo;Chácara Cuiabá;20409;20327;20289;37;82;3523107005011.0
São Paulo;Cidade Kemel;15832;15786;15775;11;46;3523107005003.0
São Paulo;Corredor I;17910;17858;17858;0;52;3523107005008.0
São Paulo;Corredor II;17667;17616;17616;0;51;3523107005009.0
São Paulo;Mandi;21921;21898;21887;11;23;3523107005015.0
São Paulo;Monte Belo;24161;24133;24133;0;28;3523107005002.0
São Paulo;Morro Branco;16838;16818;16809;9;20;3523107005005.0
São Paulo;Perobal;17079;17079;17058;21;0;3523107005010.0
São Paulo;Pium;16175;16143;16143;0;32;3523107005016.0
São Paulo;Rio Abaixo;25217;25195;25195;0;22;3523107005001.0
São Paulo;Tipóia;16108;16108;16108;0;0;3523107005007.0
São Paulo;Una;15181;14976;14933;42;205;3523107005012.0
São Paulo;Itararé;47934;47891;47870;21;43;3523206.0
São Paulo;Área 001;23964;23952;23931;21;12;3523206003001.0
São Paulo;Área 002;23970;23940;23940;0;30;3523206003002.0
São Paulo;Itariri;15471;15423;15418;5;48;3523305.0
São Paulo;Distrito 05 de Itariri;7931;7895;7890;5;36;3523305002001.0
São Paulo;Distrito 10 de Itariri;7540;7528;7528;0;12;3523305002002.0
São Paulo;Itatiba;101471;101145;101029;116;326;3523404.0
São Paulo;Área 001;13281;13240;13233;8;41;3523404003001.0
São Paulo;Área 002;16407;16407;16340;67;0;3523404003002.0
São Paulo;Área 003;14932;14910;14884;26;22;3523404003003.0
São Paulo;Área 004;27589;27459;27452;7;130;3523404003004.0
São Paulo;Área 005;29262;29128;29120;8;134;3523404003005.0
São Paulo;Itu;154147;153833;153666;167;314;3523909.0
São Paulo;Área 001;21609;21599;21582;17;10;3523909003001.0
São Paulo;Área 002;15320;15307;15307;0;13;3523909003002.0
São Paulo;Área 003;15957;15957;15948;9;0;3523909003003.0
São Paulo;Área 004;17058;17013;16981;33;45;3523909003004.0
São Paulo;Área 005;20324;20207;20155;52;117;3523909003005.0
São Paulo;Área 006;20321;20285;20285;0;36;3523909003006.0
São Paulo;Área 007;43558;43465;43409;57;93;3523909003007.0
São Paulo;Itupeva;44859;44736;44715;22;123;3524006.0
São Paulo;Área 001;17400;17377;17365;12;23;3524006003001.0
São Paulo;Área 002;27459;27359;27349;10;100;3524006003002.0
São Paulo;Ituverava;38695;38695;38661;34;0;3524105.0
São Paulo;Área 001;17912;17912;17902;10;0;3524105003001.0
São Paulo;Área 002;20783;20783;20759;24;0;3524105003002.0
São Paulo;Jaboticabal;71662;71556;71474;82;106;3524303.0
São Paulo;Área 001;14225;14213;14213;0;12;3524303003001.0
São Paulo;Área 002;29175;29146;29103;43;29;3524303003002.0
São Paulo;Área 003;28262;28196;28158;38;66;3524303003003.0
São Paulo;Jacareí;211214;210745;210586;159;469;3524402.0
São Paulo;Central;25919;25766;25675;90;153;3524402005001.0
São Paulo;Leste 1;34947;34853;34832;21;94;3524402005007.0
São Paulo;Leste 2;22152;22124;22113;12;28;3524402005008.0
São Paulo;Norte;23293;23284;23271;13;9;3524402005002.0
São Paulo;Oeste 1;38167;38068;38068;0;99;3524402005005.0
São Paulo;Oeste 2;25565;25490;25490;0;75;3524402005006.0
São Paulo;Sul 1;21653;21643;21643;0;10;3524402005003.0
São Paulo;Sul 2;19518;19518;19495;23;0;3524402005004.0
São Paulo;Jaguariúna;44311;44170;44160;10;141;3524709.0
São Paulo;Área 001;17519;17445;17445;0;74;3524709003001.0
São Paulo;Área 002;26792;26724;26714;10;68;3524709003002.0
São Paulo;Jales;47012;46918;46838;81;94;3524808.0
São Paulo;Área 001;22047;22008;21950;58;39;3524808003001.0
São Paulo;Área 002;24965;24910;24888;23;55;3524808003002.0
São Paulo;Jandira;108344;108086;108053;34;258;3525003.0
São Paulo;Área 001;15037;15037;15037;0;0;3525003003001.0
São Paulo;Área 002;15470;15470;15470;0;0;3525003003002.0
São Paulo;Área 003;15443;15414;15414;0;29;3525003003003.0
São Paulo;Área 004;28613;28470;28449;21;143;3525003003004.0
São Paulo;Área 005;33781;33695;33683;13;86;3525003003005.0
São Paulo;Jardinópolis;37661;37619;37619;0;42;3525102.0
São Paulo;Área 001;13273;13258;13258;0;15;3525102003001.0
São Paulo;Área 002;24388;24362;24362;0;26;3525102003002.0
São Paulo;Jaú;131040;131008;130900;108;32;3525300.0
São Paulo;Área 001;13304;13304;13300;4;0;3525300003001.0
São Paulo;Área 002;13153;13153;13153;0;0;3525300003002.0
São Paulo;Área 003;16552;16552;16538;14;0;3525300003003.0
São Paulo;Área 004;12189;12189;12154;35;0;3525300003004.0
São Paulo;Área 005;17823;17823;17810;13;0;3525300003005.0
São Paulo;Área 006;25903;25895;25887;9;8;3525300003006.0
São Paulo;Área 007;32116;32092;32059;33;24;3525300003007.0
São Paulo;José Bonifácio;32763;32736;32723;12;27;3525706.0
São Paulo;Área 001;13860;13841;13828;12;19;3525706003001.0
São Paulo;Área 002;18903;18895;18895;0;8;3525706003002.0
São Paulo;Jundiaí;370126;368648;368159;488;1478;3525904.0
São Paulo;Agapeama;14160;14091;14091;0;69;3525904005005.0
São Paulo;Bom Jardim-Roseira;17392;17351;17351;0;41;3525904005015.0
São Paulo;Caxambu-Jundiai-Mirim;14013;13978;13963;14;35;3525904005020.0
São Paulo;Cecap-Parque Centenário;15612;15586;15586;0;26;3525904005016.0
São Paulo;Centro;11229;11070;11033;38;159;3525904005009.0
São Paulo;Chácara Urbana-Retiro;11841;11640;11571;69;201;3525904005010.0
São Paulo;Colônia-Ivoturucaia;14122;14100;14091;9;22;3525904005024.0
São Paulo;Eloy Chaves-Medeiros;20850;20690;20690;0;160;3525904005013.0
São Paulo;Engordadouro-Torres de São José;16155;16113;16072;41;42;3525904005017.0
São Paulo;Jardim do Lago;15057;15030;15030;0;27;3525904005004.0
São Paulo;Jardim Novo Horizonte;26518;26504;26495;9;14;3525904005014.0
São Paulo;Jardim Pacaembu-Ponte São João;16325;16195;16147;49;130;3525904005022.0
São Paulo;Jardim São Camilo-Jardim Tarumã;16954;16941;16941;0;13;3525904005021.0
São Paulo;Jardim Tamoio-Vila Nambi;20997;20997;20985;12;0;3525904005023.0
São Paulo;Malota-Anhangabau;14154;14074;14040;34;80;3525904005008.0
São Paulo;Serra do Japi-Santa Gertrudes;15351;15344;15344;0;7;3525904005001.0
São Paulo;Tulipas-Bairro do Poste;14988;14952;14942;10;36;3525904005012.0
São Paulo;Vianelo;13057;12940;12890;49;117;3525904005007.0
São Paulo;Vila Alvorada;13616;13551;13517;34;65;3525904005011.0
São Paulo;Vila Arens-Vila Progresso;12367;12287;12227;60;80;3525904005006.0
São Paulo;Vila Hortolândia;14167;14160;14140;20;7;3525904005018.0
São Paulo;Vila Maringá;15577;15536;15536;0;41;3525904005002.0
São Paulo;Vila Rami-Jardim Bonfiglioli;14186;14109;14076;34;77;3525904005003.0
São Paulo;Vila Rio Branco-Marco Leite;11438;11406;11399;7;32;3525904005019.0
São Paulo;Leme;91756;91644;91623;21;112;3526704.0
São Paulo;Área 001;12139;12088;12088;0;51;3526704003001.0
São Paulo;Área 002;14444;14444;14444;0;0;3526704003002.0
São Paulo;Área 003;13022;12998;12998;0;24;3526704003003.0
São Paulo;Área 004;24938;24911;24900;11;27;3526704003004.0
São Paulo;Área 005;27213;27203;27193;10;10;3526704003005.0
São Paulo;Lençóis Paulista;61428;61355;61327;28;73;3526803.0
São Paulo;Área 001;15489;15485;15485;0;4;3526803003001.0
São Paulo;Área 002;16675;16642;16625;17;33;3526803003002.0
São Paulo;Área 003;29264;29228;29217;11;36;3526803003003.0
São Paulo;Limeira;276022;275772;275614;158;250;3526902.0
São Paulo;Belinha Ometto;43443;43421;43408;12;22;3526902005001.0
São Paulo;Centro;28226;28116;28086;30;110;3526902005006.0
São Paulo;Ernesto Kuhl;64664;64654;64644;10;10;3526902005004.0
São Paulo;Graminha;43736;43678;43657;21;58;3526902005005.0
São Paulo;Hipolito;62062;62052;61989;63;10;3526902005003.0
São Paulo;Roland;33891;33850;33829;21;41;3526902005002.0
São Paulo;Lins;71432;71201;71103;98;231;3527108.0
São Paulo;Área 001;19424;19302;19255;47;122;3527108003001.0
São Paulo;Área 002;24131;24068;24047;21;63;3527108003002.0
São Paulo;Área 003;27877;27831;27801;31;46;3527108003003.0
São Paulo;Lorena;82537;82378;82323;55;159;3527207.0
São Paulo;Área 001;15159;15159;15159;0;0;3527207003001.0
São Paulo;Área 002;15330;15300;15291;9;30;3527207003002.0
São Paulo;Área 003;22062;22017;21980;37;45;3527207003003.0
São Paulo;Área 004;29986;29902;29893;9;84;3527207003004.0
São Paulo;Louveira;37125;37062;37062;0;63;3527306.0
São Paulo;Área 001;22178;22124;22124;0;54;3527306003001.0
São Paulo;Área 002;14947;14937;14937;0;10;3527306003002.0
São Paulo;Mairinque;43223;43158;43105;54;65;3528403.0
São Paulo;Área 001;17192;17154;17132;23;38;3528403003001.0
São Paulo;Área 002;26031;26004;25973;31;27;3528403003002.0
São Paulo;Mairiporã;80956;80618;80469;149;338;3528502.0
São Paulo;Área 001;15992;15945;15933;12;47;3528502003001.0
São Paulo;Área 002;31448;31374;31331;43;74;3528502003002.0
São Paulo;Área 003;33516;33299;33206;94;217;3528502003003.0
São Paulo;Marília;216745;216281;215994;287;464;3529005.0
São Paulo;Central;17316;17182;17110;72;134;3529005005008.0
São Paulo;Centro-Norte;20501;20481;20472;9;20;3529005005003.0
São Paulo;Centro-Sul;18275;18258;18258;0;17;3529005005006.0
São Paulo;Extremo-Sul;22325;22316;22306;10;9;3529005005005.0
São Paulo;Leste;31258;31148;31076;72;110;3529005005004.0
São Paulo;Meio-Norte;13037;12926;12916;10;111;3529005005009.0
São Paulo;Norte-1;29285;29263;29250;12;22;3529005005001.0
São Paulo;Norte-2;21684;21675;21651;25;9;3529005005002.0
São Paulo;Oeste;27343;27325;27317;8;18;3529005005010.0
São Paulo;Sul;15721;15708;15639;70;13;3529005005007.0
São Paulo;Matão;76786;76748;76718;29;38;3529302.0
São Paulo;Área 001;13547;13547;13537;10;0;3529302003001.0
São Paulo;Área 002;16896;16884;16884;0;12;3529302003002.0
São Paulo;Área 003;21616;21616;21597;19;0;3529302003003.0
São Paulo;Área 004;24727;24700;24700;0;27;3529302003004.0
São Paulo;Mauá;417064;416393;416229;163;671;3529401.0
São Paulo;Centro;13218;13127;13127;0;91;3529401005001.0
São Paulo;Jd. Alto da Boa Vista;14411;14401;14389;12;10;3529401005002.0
São Paulo;Jd. Feital;28588;28588;28572;16;0;3529401005003.0
São Paulo;Jd. Haydee-Vila Vitória;22106;22023;21992;31;83;3529401005004.0
São Paulo;Jd. Itapark;29988;29908;29895;13;80;3529401005005.0
São Paulo;Jd. Itapeva;13834;13760;13760;0;74;3529401005006.0
São Paulo;Jd. Oratório;29565;29565;29557;8;0;3529401005007.0
São Paulo;Jd. Zaira II;17456;17441;17441;0;15;3529401005009.0
São Paulo;Jd. Zaíra III e IV;18442;18424;18424;0;18;3529401005008.0
São Paulo;Luzitano-Hélida-São Lúcido;15725;15703;15703;0;22;3529401005010.0
São Paulo;Macuco;25761;25761;25761;0;0;3529401005011.0
São Paulo;Miranda-Jardim Mauá;24205;24205;24205;0;0;3529401005012.0
São Paulo;Nucleo Cincinato Braga;16659;16630;16630;0;29;3529401005013.0
São Paulo;Pq. Bandeirantes;18567;18545;18545;0;22;3529401005014.0
São Paulo;Pq. das Américas;17237;17237;17227;10;0;3529401005015.0
São Paulo;Pq. São Vicente-Capuava-Jds. Sonia e Silvia Maria;27440;27361;27331;29;79;3529401005016.0
São Paulo;Santa Lídia;23993;23907;23896;10;86;3529401005017.0
São Paulo;Sertãozinho-Vila Mercedes;15181;15150;15141;9;31;3529401005018.0
São Paulo;Vila Assis Brasil;13763;13741;13728;13;22;3529401005019.0
São Paulo;Vl. Magini;15668;15659;15647;11;9;3529401005020.0
São Paulo;Vl. Nova Mauá;15257;15257;15257;0;0;3529401005021.0
São Paulo;Mirassol;53792;53742;53721;21;50;3530300.0
São Paulo;Área 001;24353;24342;24321;21;11;3530300003001.0
São Paulo;Área 002;29439;29400;29400;0;39;3530300003002.0
São Paulo;Mococa;66290;66229;66221;8;61;3530508.0
São Paulo;Área 001;12779;12779;12771;8;0;3530508003001.0
São Paulo;Área 002;15411;15398;15398;0;13;3530508003002.0
São Paulo;Área 003;11602;11577;11577;0;25;3530508003003.0
São Paulo;Área 004;26498;26475;26475;0;23;3530508003004.0
São Paulo;Mogi das Cruzes;387779;385615;385055;560;2164;3530607.0
São Paulo;Alto do Ipiranga;13491;13319;13261;58;172;3530607005001.0
São Paulo;Botujuru;14759;14706;14677;29;53;3530607005002.0
São Paulo;Braz Cubas;15300;15204;15184;20;96;3530607005003.0
São Paulo;Centro;12489;12245;12223;22;244;3530607005004.0
São Paulo;Cezar de Souza;15262;15211;15160;51;51;3530607005005.0
São Paulo;Cocuera;17196;17166;17159;6;30;3530607005006.0
São Paulo;Itapeti;21912;21832;21832;0;80;3530607005007.0
São Paulo;Jardim Aeroporto;15730;15720;15720;0;10;3530607005008.0
São Paulo;Jardim Planalto;18334;18307;18261;47;27;3530607005009.0
São Paulo;Jardim São Pedro;13964;13884;13866;18;80;3530607005010.0
São Paulo;Jardim Universo;15881;15850;15841;9;31;3530607005011.0
São Paulo;Jundiapeba;17606;17526;17504;22;80;3530607005012.0
São Paulo;Mogi Moderno;13627;13501;13467;34;126;3530607005013.0
São Paulo;Parque das Varinhas;14572;14544;14532;13;28;3530607005014.0
São Paulo;Pq. Olimpico;16107;16092;16092;0;15;3530607005015.0
São Paulo;Rodeio;16943;16867;16833;33;76;3530607005016.0
São Paulo;São João;13869;13823;13814;9;46;3530607005017.0
São Paulo;Sul;15677;15519;15519;0;158;3530607005018.0
São Paulo;Vila da Prata;17457;17379;17370;8;78;3530607005019.0
São Paulo;Vila Industrial;16388;16184;16170;14;204;3530607005020.0
São Paulo;Vila Jundiaí;16139;16071;16071;0;68;3530607005021.0
São Paulo;Vila Lavínia;19118;18913;18820;93;205;3530607005022.0
São Paulo;Vila Nova Jundiapeba;17561;17561;17561;0;0;3530607005023.0
São Paulo;Vila Oliveira;18397;18191;18116;75;206;3530607005024.0
São Paulo;Mogi Guaçu;137245;137032;136975;57;213;3530706.0
São Paulo;Área 001;14304;14276;14276;0;28;3530706003001.0
São Paulo;Área 002;16622;16622;16622;0;0;3530706003002.0
São Paulo;Área 003;16043;16022;16012;10;21;3530706003003.0
São Paulo;Área 004;16335;16306;16297;9;29;3530706003004.0
São Paulo;Área 005;12356;12330;12330;0;26;3530706003005.0
São Paulo;Área 006;20641;20588;20569;18;53;3530706003006.0
São Paulo;Área 007;16551;16520;16520;0;31;3530706003007.0
São Paulo;Área 008;24393;24369;24350;19;24;3530706003008.0
São Paulo;Moji Mirim;86505;86327;86232;96;178;3530805.0
São Paulo;Área 001;18558;18512;18459;53;46;3530805003001.0
São Paulo;Área 002;20767;20736;20724;11;31;3530805003002.0
São Paulo;Área 003;28211;28141;28110;31;70;3530805003003.0
São Paulo;Área 004;18969;18938;18938;0;31;3530805003004.0
São Paulo;Mongaguá;46293;45976;45909;66;317;3531100.0
São Paulo;Área 001;21347;21191;21152;39;156;3531100003001.0
São Paulo;Área 002;24946;24785;24757;27;161;3531100003002.0
São Paulo;Monte Alto;46642;46559;46505;54;83;3531308.0
São Paulo;Área 001;14388;14375;14343;32;13;3531308003001.0
São Paulo;Área 002;32254;32184;32162;22;70;3531308003002.0
São Paulo;Monte Mor;48949;48904;48895;9;45;3531803.0
São Paulo;Área 001;17555;17542;17533;9;13;3531803003001.0
São Paulo;Área 002;31394;31362;31362;0;32;3531803003002.0
São Paulo;Nova Odessa;51242;51134;51134;0;108;3533403.0
São Paulo;Área 001;21925;21925;21925;0;0;3533403003001.0
São Paulo;Área 002;29317;29209;29209;0;108;3533403003002.0
São Paulo;Novo Horizonte;36593;36552;36542;10;41;3533502.0
São Paulo;Área 001;12943;12914;12914;0;29;3533502003001.0
São Paulo;Área 002;23650;23638;23628;10;12;3533502003002.0
São Paulo;Olímpia;50024;49972;49865;107;52;3533908.0
São Paulo;Área 001;23663;23654;23573;81;9;3533908003001.0
São Paulo;Área 002;26361;26319;26292;27;42;3533908003002.0
São Paulo;Orlândia;39781;39773;39751;22;8;3534302.0
São Paulo;Área 001;14185;14185;14174;11;0;3534302003001.0
São Paulo;Área 002;25596;25588;25578;10;8;3534302003002.0
São Paulo;Osasco;666740;664447;663973;474;2293;3534401.0
São Paulo;Aliança;36304;36051;36051;0;253;3534401005006.0
São Paulo;Ayrosa;30357;30102;30072;30;255;3534401005003.0
São Paulo;Centro;31797;31415;31315;100;382;3534401005009.0
São Paulo;Cipava;41306;41129;41082;47;177;3534401005011.0
São Paulo;Conceição;48422;48338;48338;0;84;3534401005015.0
São Paulo;Jardim D'abril;29773;29659;29628;31;114;3534401005016.0
São Paulo;Km 18;42501;42300;42209;90;201;3534401005008.0
São Paulo;Munhoz Jr.;29859;29859;29859;0;0;3534401005005.0
São Paulo;Padroeira;42279;42279;42279;0;0;3534401005013.0
São Paulo;Paiva Ramos;40000;39948;39948;0;52;3534401005001.0
São Paulo;Pestana;47613;47515;47474;41;98;3534401005012.0
São Paulo;Portal do Oeste;33036;32959;32959;0;77;3534401005004.0
São Paulo;Presidente Altino;37098;37002;37002;0;96;3534401005007.0
São Paulo;Rochdale;30352;30327;30327;0;25;3534401005017.0
São Paulo;Santa Maria;47044;47023;47006;18;21;3534401005014.0
São Paulo;Veloso;32524;32460;32460;0;64;3534401005018.0
São Paulo;Vila Menk;36353;36267;36267;0;86;3534401005002.0
São Paulo;Vila Yara;30122;29814;29696;118;308;3534401005010.0
São Paulo;Osvaldo Cruz;30917;30819;30752;67;98;3534609.0
São Paulo;Área 001;15223;15125;15086;39;98;3534609003001.0
São Paulo;Área 002;15694;15694;15666;28;0;3534609003002.0
São Paulo;Ourinhos;103035;102844;102777;67;191;3534708.0
São Paulo;Área 001;12683;12611;12611;0;72;3534708003001.0
São Paulo;Área 002;13982;13952;13952;0;30;3534708003002.0
São Paulo;Área 003;20664;20664;20664;0;0;3534708003003.0
São Paulo;Área 004;24353;24287;24244;44;66;3534708003004.0
São Paulo;Área 005;31353;31330;31306;23;23;3534708003005.0
São Paulo;Paraguaçu Paulista;42278;42278;42230;48;0;3535507.0
São Paulo;Área 001;16988;16988;16978;10;0;3535507003001.0
São Paulo;Área 002;25290;25290;25252;38;0;3535507003002.0
São Paulo;Paulínia;82146;81967;81945;22;179;3536505.0
São Paulo;Área 001;14654;14633;14633;0;21;3536505003001.0
São Paulo;Área 002;18502;18481;18468;13;21;3536505003002.0
São Paulo;Área 003;22747;22706;22706;0;41;3536505003003.0
São Paulo;Área 004;26243;26147;26138;9;96;3536505003004.0
São Paulo;Pederneiras;41497;41497;41497;0;0;3536703.0
São Paulo;Área 001;16248;16248;16248;0;0;3536703003001.0
São Paulo;Área 002;25249;25249;25249;0;0;3536703003002.0
São Paulo;Pedreira;41558;41516;41505;10;42;3537107.0
São Paulo;Área 001;19375;19364;19354;10;11;3537107003001.0
São Paulo;Área 002;22183;22151;22151;0;32;3537107003002.0
São Paulo;Penápolis;58510;58464;58419;46;46;3537305.0
São Paulo;Área 001;13629;13621;13621;0;8;3537305003001.0
São Paulo;Área 002;21169;21132;21100;32;37;3537305003002.0
São Paulo;Área 003;23712;23712;23698;14;0;3537305003003.0
São Paulo;Peruíbe;59773;59206;59062;145;567;3537602.0
São Paulo;Área 001;12559;12380;12315;65;179;3537602003001.0
São Paulo;Área 002;18450;18283;18244;40;167;3537602003002.0
São Paulo;Área 003;28764;28543;28503;40;221;3537602003003.0
São Paulo;Piedade;52143;52045;51959;86;98;3537800.0
São Paulo;Área 001;26768;26728;26712;16;40;3537800003001.0
São Paulo;Área 002;25375;25317;25246;70;58;3537800003002.0
São Paulo;Pindamonhangaba;146995;146748;146683;65;247;3538006.0
São Paulo;Área 001;14485;14469;14469;0;16;3538006003001.0
São Paulo;Área 002;13064;13031;13031;0;33;3538006003002.0
São Paulo;Área 003;15240;15228;15228;0;12;3538006003003.0
São Paulo;Área 004;16656;16582;16569;13;74;3538006003004.0
São Paulo;Área 005;21214;21204;21204;0;10;3538006003005.0
São Paulo;Área 006;26067;25984;25965;19;83;3538006003006.0
São Paulo;Área 007;40269;40249;40216;33;20;3538006003007.0
São Paulo;Piracicaba;364571;363875;363666;209;696;3538709.0
São Paulo;Centro 1;13108;12969;12924;44;139;3538709005001.0
São Paulo;Centro 2;13049;13018;12997;21;31;3538709005002.0
São Paulo;Centro 3;15265;15211;15201;10;54;3538709005003.0
São Paulo;Centro 4;17301;17243;17243;0;58;3538709005004.0
São Paulo;Leste 1;14543;14485;14474;11;58;3538709005012.0
São Paulo;Leste 2;13387;13352;13337;15;35;3538709005013.0
São Paulo;Leste 3;20913;20869;20859;10;44;3538709005014.0
São Paulo;Leste 4;14566;14554;14554;0;12;3538709005015.0
São Paulo;Norte 1;26700;26688;26677;11;12;3538709005008.0
São Paulo;Norte 2;20247;20247;20247;0;0;3538709005009.0
São Paulo;Norte 3;16037;16026;16020;6;11;3538709005010.0
São Paulo;Norte 4;21549;21549;21537;12;0;3538709005011.0
São Paulo;Oeste 1;18931;18919;18919;0;12;3538709005005.0
São Paulo;Oeste 2;24794;24794;24783;11;0;3538709005006.0
São Paulo;Oeste 3;14677;14603;14603;0;74;3538709005007.0
São Paulo;Sul 1;20496;20450;20430;20;46;3538709005016.0
São Paulo;Sul 2;21388;21378;21378;0;10;3538709005017.0
São Paulo;Sul 3;14952;14946;14946;0;6;3538709005018.0
São Paulo;Sul 4;20714;20622;20589;32;92;3538709005019.0
São Paulo;Zona Rural e Distritos;21954;21954;21947;7;0;3538709005020.0
São Paulo;Piraju;28475;28453;28453;0;22;3538808.0
São Paulo;Área 001;12602;12602;12602;0;0;3538808003001.0
São Paulo;Área 002;15873;15851;15851;0;22;3538808003002.0
São Paulo;Pirassununga;70081;70045;70013;31;36;3539301.0
São Paulo;Área 001;13699;13691;13691;0;8;3539301003001.0
São Paulo;Área 002;15709;15709;15709;0;0;3539301003002.0
São Paulo;Área 003;19227;19217;19217;0;10;3539301003003.0
São Paulo;Área 004;21446;21428;21396;31;18;3539301003004.0
São Paulo;Pitangueiras;35307;35298;35298;0;9;3539509.0
São Paulo;Área 001;15658;15658;15658;0;0;3539509003001.0
São Paulo;Área 002;19649;19640;19640;0;9;3539509003002.0
São Paulo;Poá;106013;105843;105766;77;170;3539806.0
São Paulo;Área 001;16279;16279;16260;19;0;3539806003001.0
São Paulo;Área 002;17962;17941;17918;23;21;3539806003002.0
São Paulo;Área 003;12687;12644;12622;22;43;3539806003003.0
São Paulo;Área 004;19584;19546;19546;0;38;3539806003004.0
São Paulo;Área 005;39501;39433;39420;13;68;3539806003005.0
São Paulo;Pontal;40244;40235;40235;0;9;3540200.0
São Paulo;Área 001;13975;13966;13966;0;9;3540200003001.0
São Paulo;Área 002;26269;26269;26269;0;0;3540200003002.0
São Paulo;Porto Feliz;48893;48829;48773;56;64;3540606.0
São Paulo;Área 001;20435;20383;20360;23;52;3540606003001.0
São Paulo;Área 002;28458;28446;28413;33;12;3540606003002.0
São Paulo;Porto Ferreira;51400;51357;51337;20;43;3540705.0
São Paulo;Área 001;20458;20422;20412;9;36;3540705003001.0
São Paulo;Área 002;30942;30935;30924;11;7;3540705003002.0
São Paulo;Praia Grande;262051;260454;260083;371;1597;3541000.0
São Paulo;Área 001;25451;25035;24954;81;416;3541000005001.0
São Paulo;Área 002;24355;23984;23963;21;371;3541000005002.0
São Paulo;Área 003;26258;25997;25887;110;261;3541000005003.0
São Paulo;Área 004;28250;27928;27845;83;322;3541000005004.0
São Paulo;Área 005;28683;28637;28637;0;46;3541000005005.0
São Paulo;Área 006;21351;21340;21340;0;11;3541000005006.0
São Paulo;Área 007;31122;31122;31109;13;0;3541000005007.0
São Paulo;Área 008;21103;21065;21065;0;38;3541000005008.0
São Paulo;Área 009;39796;39713;39681;31;83;3541000005009.0
São Paulo;Área 010;15682;15634;15602;31;48;3541000005010.0
São Paulo;Presidente Epitácio;41318;41269;41227;42;49;3541307.0
São Paulo;Área 001;19610;19590;19575;16;20;3541307003001.0
São Paulo;Área 002;21708;21679;21653;26;29;3541307003002.0
São Paulo;Presidente Prudente;207610;207312;207004;308;298;3541406.0
São Paulo;Área 001;14928;14868;14789;79;60;3541406005001.0
São Paulo;Área 002;16276;16222;16205;18;54;3541406005002.0
São Paulo;Área 003;12341;12292;12274;18;49;3541406005003.0
São Paulo;Área 004;15190;15173;15123;50;17;3541406005004.0
São Paulo;Área 005;25653;25623;25565;58;30;3541406005005.0
São Paulo;Área 006;20160;20148;20138;10;12;3541406005006.0
São Paulo;Área 007;15088;15088;15088;0;0;3541406005007.0
São Paulo;Área 008;13563;13550;13550;0;13;3541406005008.0
São Paulo;Área 009;16074;16063;16063;0;11;3541406005009.0
São Paulo;Área 010;15255;15218;15173;45;37;3541406005010.0
São Paulo;Área 011;27773;27760;27743;17;13;3541406005011.0
São Paulo;Área 012;15309;15305;15294;11;4;3541406005012.0
São Paulo;Presidente Venceslau;37910;37855;37745;110;55;3541505.0
São Paulo;Área 001;15505;15482;15435;47;23;3541505003001.0
São Paulo;Área 002;22405;22373;22310;63;32;3541505003002.0
São Paulo;Promissão;35674;35633;35633;0;41;3541604.0
São Paulo;Área 001;15601;15601;15601;0;0;3541604003001.0
São Paulo;Área 002;20073;20032;20032;0;41;3541604003002.0
São Paulo;Rancharia;28804;28764;28764;0;40;3542206.0
São Paulo;Área 001;12381;12354;12354;0;27;3542206003001.0
São Paulo;Área 002;16423;16410;16410;0;13;3542206003002.0
São Paulo;Registro;54261;54174;54060;114;87;3542602.0
São Paulo;Área 001;26597;26574;26518;55;23;3542602003001.0
São Paulo;Área 002;27664;27601;27542;59;63;3542602003002.0
São Paulo;Ribeirão Pires;113068;112613;112512;101;455;3543303.0
São Paulo;Área 001;16377;16359;16338;21;18;3543303003001.0
São Paulo;Área 002;17441;17388;17388;0;53;3543303003002.0
São Paulo;Área 003;18136;18040;18017;24;96;3543303003003.0
São Paulo;Área 004;14782;14665;14651;14;117;3543303003004.0
São Paulo;Área 005;23360;23259;23250;9;101;3543303003005.0
São Paulo;Área 006;22972;22902;22869;33;70;3543303003006.0
São Paulo;Ribeirão Preto;604682;603509;602983;526;1173;3543402.0
São Paulo;Área 001;23759;23487;23439;48;272;3543402005001.0
São Paulo;Área 002;36370;36311;36245;66;59;3543402005002.0
São Paulo;Área 003;27843;27782;27782;0;61;3543402005003.0
São Paulo;Área 004;35317;35303;35303;0;14;3543402005004.0
São Paulo;Área 005;31428;31428;31410;18;0;3543402005005.0
São Paulo;Área 006;42282;42252;42252;0;30;3543402005006.0
São Paulo;Área 007;32038;31976;31956;21;62;3543402005007.0
São Paulo;Área 008;22947;22892;22792;101;55;3543402005008.0
São Paulo;Área 009;26237;26171;26150;22;66;3543402005009.0
São Paulo;Área 010;33268;33202;33182;21;66;3543402005010.0
São Paulo;Área 011;30062;30043;30043;0;19;3543402005011.0
São Paulo;Área 012;31546;31345;31313;31;201;3543402005012.0
São Paulo;Área 013;40678;40667;40611;56;11;3543402005013.0
São Paulo;Área 014;44353;44318;44318;0;35;3543402005014.0
São Paulo;Área 015;30028;29910;29858;52;118;3543402005015.0
São Paulo;Área 016;31652;31620;31575;44;32;3543402005016.0
São Paulo;Área 017;40198;40179;40156;23;19;3543402005017.0
São Paulo;Área 018;31448;31426;31426;0;22;3543402005018.0
São Paulo;Área 019;13228;13198;13173;25;30;3543402005019.0
São Paulo;Rio Claro;186253;185867;185741;126;386;3543907.0
São Paulo;Área 001;15643;15643;15643;0;0;3543907003001.0
São Paulo;Área 002;14024;14018;14018;0;6;3543907003002.0
São Paulo;Área 003;37520;37386;37319;68;134;3543907003003.0
São Paulo;Área 004;18434;18410;18400;10;24;3543907003004.0
São Paulo;Área 005;13422;13411;13411;0;11;3543907003005.0
São Paulo;Área 006;12031;12003;11994;9;28;3543907003006.0
São Paulo;Área 007;13811;13754;13754;0;57;3543907003007.0
São Paulo;Área 008;17868;17850;17837;12;18;3543907003008.0
São Paulo;Área 009;22922;22860;22860;0;62;3543907003009.0
São Paulo;Área 010;20578;20532;20505;27;46;3543907003010.0
São Paulo;Rio Grande da Serra;43974;43936;43917;18;38;3544103.0
São Paulo;Área 001;19920;19901;19891;10;19;3544103003001.0
São Paulo;Área 002;24054;24035;24026;9;19;3544103003002.0
São Paulo;Salto;105516;105336;105248;88;180;3545209.0
São Paulo;Área 001;13959;13939;13934;5;20;3545209003001.0
São Paulo;Área 002;15122;15077;15061;15;45;3545209003002.0
São Paulo;Área 003;18536;18501;18474;27;35;3545209003003.0
São Paulo;Área 004;15623;15593;15574;19;30;3545209003004.0
São Paulo;Área 005;19880;19848;19827;21;32;3545209003005.0
São Paulo;Área 006;22396;22378;22378;0;18;3545209003006.0
São Paulo;Salto de Pirapora;40132;40032;40032;0;100;3545308.0
São Paulo;Área 001;15998;15957;15957;0;41;3545308003001.0
São Paulo;Área 002;24134;24075;24075;0;59;3545308003002.0
São Paulo;Santa Bárbara d'Oeste;180009;179727;179607;120;282;3545803.0
São Paulo;Área 001;13774;13774;13766;8;0;3545803003001.0
São Paulo;Área 002;14996;14996;14996;0;0;3545803003002.0
São Paulo;Área 003;12492;12482;12461;21;10;3545803003003.0
São Paulo;Área 004;15766;15755;15744;11;11;3545803003004.0
São Paulo;Área 005;34969;34928;34900;28;41;3545803003005.0
São Paulo;Área 006;15022;15022;15014;8;0;3545803003006.0
São Paulo;Área 007;20944;20880;20845;35;64;3545803003007.0
São Paulo;Área 008;52046;51890;51882;8;156;3545803003008.0
São Paulo;Santa Cruz das Palmeiras;29932;29932;29924;8;0;3546306.0
São Paulo;Área 001;12785;12785;12777;8;0;3546306003001.0
São Paulo;Área 002;17147;17147;17147;0;0;3546306003002.0
São Paulo;Santa Cruz do Rio Pardo;43921;43912;43912;0;9;3546405.0
São Paulo;Área 001;21370;21361;21361;0;9;3546405003001.0
São Paulo;Área 002;22551;22551;22551;0;0;3546405003002.0
São Paulo;Santa Fé do Sul;29239;29208;29170;38;31;3546603.0
São Paulo;Área 001;12746;12746;12724;22;0;3546603003001.0
São Paulo;Área 002;16493;16462;16446;16;31;3546603003002.0
São Paulo;Santa Isabel;50453;50197;50144;53;256;3546801.0
São Paulo;Área 001;25267;25121;25093;28;146;3546801003001.0
São Paulo;Área 002;25186;25076;25051;25;110;3546801003002.0
São Paulo;Santana de Parnaíba;108813;107879;107671;208;934;3547304.0
São Paulo;Área 001;16085;16073;16059;14;12;3547304003001.0
São Paulo;Área 002;15761;15751;15741;10;10;3547304003002.0
São Paulo;Área 003;31950;31741;31741;0;209;3547304003003.0
São Paulo;Área 004;45017;44314;44130;184;703;3547304003004.0
São Paulo;Santo André;676407;672359;671686;672;4048;3547809.0
São Paulo;Assunção;24260;23834;23814;20;426;3547809005001.0
São Paulo;Camilópolis;26908;26822;26798;24;86;3547809005002.0
São Paulo;Campestre;34915;34563;34490;73;352;3547809005003.0
São Paulo;Cata Preta;35012;34991;34991;0;21;3547809005004.0
São Paulo;Centro;23237;22765;22650;115;472;3547809005005.0
São Paulo;Cidade São Jorge;34596;34537;34537;0;59;3547809005006.0
São Paulo;Condomínio Maracanã;36607;36505;36487;18;102;3547809005007.0
São Paulo;Jardim Bom Pastor;28149;27655;27600;55;494;3547809005008.0
São Paulo;Jardim Cristiane;30870;30686;30594;92;184;3547809005009.0
São Paulo;Jardim do Estádio;27520;27473;27439;34;47;3547809005010.0
São Paulo;Jardim Santo André;33267;33251;33251;0;16;3547809005011.0
São Paulo;Nações;28016;27646;27646;0;370;3547809005012.0
São Paulo;Parque Andreense;16757;16757;16748;9;0;3547809005013.0
São Paulo;Parque Capuava;30830;30805;30805;0;25;3547809005014.0
São Paulo;Parque João Ramalho;30324;30140;30058;82;184;3547809005015.0
São Paulo;Parque Novo Oratório;27821;27686;27686;0;135;3547809005016.0
São Paulo;Parque Oratório;27052;26946;26918;27;106;3547809005017.0
São Paulo;Santa Terezinha;27574;27390;27346;44;184;3547809005018.0
São Paulo;Vila Humaita;27902;27711;27702;9;191;3547809005019.0
São Paulo;Vila Linda;32099;32099;32074;25;0;3547809005020.0
São Paulo;Vila Luzita;26838;26708;26708;0;130;3547809005021.0
São Paulo;Vila Palmares;36235;36083;36076;8;152;3547809005022.0
São Paulo;Vila Pires;29618;29305;29266;39;313;3547809005023.0
São Paulo;Santos;419400;412455;410459;1996;6945;3548500.0
São Paulo;Dique;14074;14074;14074;0;0;3548500005001.0
São Paulo;Morros;31515;31306;31214;92;209;3548500005004.0
São Paulo;Orla1;77411;75636;74987;649;1775;3548500005005.0
São Paulo;Orla2;77103;75171;74697;474;1932;3548500005006.0
São Paulo;Zona Central;31182;30815;30701;114;367;3548500005008.0
São Paulo;Zona Intermediária;116053;113609;113075;534;2444;3548500005007.0
São Paulo;Zona Noroeste 1;31823;31694;31683;11;129;3548500005002.0
São Paulo;Zona Noroeste 2;40239;40150;40028;122;89;3548500005003.0
São Paulo;São Bernardo do Campo;765463;761360;760017;1342;4103;3548708.0
São Paulo;Alves Dias-Cooperativa;54614;54505;54474;31;109;3548708005001.0
São Paulo;Assunção;41828;41518;41260;257;310;3548708005002.0
São Paulo;Baeta Neves;49314;49000;48942;59;314;3548708005003.0
São Paulo;Batistini;28726;28726;28679;47;0;3548708005004.0
São Paulo;Centro;33196;32866;32702;164;330;3548708005005.0
São Paulo;Centro-Anchieta;31245;30760;30629;131;485;3548708005006.0
São Paulo;Demarchi-Botujuru;37359;37103;37083;20;256;3548708005007.0
São Paulo;Dos Alvarenga 1;33181;33158;33123;35;23;3548708005008.0
São Paulo;Dos Alvarenga 2;29720;29698;29664;34;22;3548708005009.0
São Paulo;Dos Casa;50238;49961;49918;43;277;3548708005010.0
São Paulo;Ferrazópolis;41313;41293;41293;0;20;3548708005011.0
São Paulo;Independência-Planalto;52274;51960;51913;48;314;3548708005012.0
São Paulo;Jordanópolis-Paulicéia;41089;40613;40476;136;476;3548708005013.0
São Paulo;Montanhão 1;43864;43864;43864;0;0;3548708005014.0
São Paulo;Montanhão 2;50380;50344;50344;0;36;3548708005015.0
São Paulo;Nova Petrópolis-Santa Terezinha;45799;45538;45420;118;261;3548708005016.0
São Paulo;Riacho Grande-Balneária;32048;31895;31849;46;153;3548708005017.0
São Paulo;Rudge Ramos;42285;41781;41669;112;504;3548708005018.0
São Paulo;Taboão;26990;26776;26715;61;214;3548708005019.0
São Paulo;São Caetano do Sul;149263;147306;146866;440;1957;3548807.0
São Paulo;Área 001;12921;12845;12835;10;76;3548807003001.0
São Paulo;Área 002;17691;17549;17544;6;142;3548807003002.0
São Paulo;Área 003;12301;12066;12034;32;235;3548807003003.0
São Paulo;Área 004;22016;21620;21575;45;396;3548807003004.0
São Paulo;Área 005;13175;13062;13046;16;113;3548807003005.0
São Paulo;Área 006;17374;17211;17161;50;163;3548807003006.0
São Paulo;Área 007;26517;26149;26002;146;368;3548807003007.0
São Paulo;Área 008;27268;26805;26670;135;463;3548807003008.0
São Paulo;São Carlos;221950;221232;220959;274;718;3548906.0
São Paulo;Centro;12133;12061;12054;7;72;3548906005001.0
São Paulo;Cidade Aracy;23037;23037;23014;23;0;3548906005008.0
São Paulo;Cidade Jardim;10961;10802;10721;81;159;3548906005002.0
São Paulo;Cruzeiro do Sul;17312;17296;17296;0;16;3548906005007.0
São Paulo;Jardim Beatriz;19695;19675;19675;0;20;3548906005009.0
São Paulo;Jockey Club;14234;14149;14128;21;85;3548906005013.0
São Paulo;Maria S. Faggá;20360;20318;20310;8;42;3548906005004.0
São Paulo;Planalto Paraíso;13052;12912;12852;60;140;3548906005011.0
São Paulo;Rural;13726;13705;13685;19;21;3548906005014.0
São Paulo;Sabará;13568;13538;13520;18;30;3548906005005.0
São Paulo;Santa Felícia;20901;20853;20845;7;48;3548906005012.0
São Paulo;Vila Isabel;14518;14479;14460;19;39;3548906005006.0
São Paulo;Vila Prado;13613;13595;13595;0;18;3548906005010.0
São Paulo;Vila São José;14840;14813;14802;10;27;3548906005003.0
São Paulo;São João da Boa Vista;83639;83566;83557;9;73;3549102.0
São Paulo;Área 001;11561;11561;11561;0;0;3549102003001.0
São Paulo;Área 002;14735;14735;14735;0;0;3549102003002.0
São Paulo;Área 003;14579;14579;14579;0;0;3549102003003.0
São Paulo;Área 004;18681;18670;18670;0;11;3549102003004.0
São Paulo;Área 005;24083;24021;24012;9;62;3549102003005.0
São Paulo;São Joaquim da Barra;46512;46489;46481;8;23;3549409.0
São Paulo;Área 001;24033;24033;24033;0;0;3549409003001.0
São Paulo;Área 002;22479;22456;22448;8;23;3549409003002.0
São Paulo;São José do Rio Pardo;51900;51846;51815;30;54;3549706.0
São Paulo;Área 001;24939;24915;24915;0;24;3549706003001.0
São Paulo;Área 002;26961;26930;26900;30;31;3549706003002.0
São Paulo;São José do Rio Preto;408258;407546;407004;542;712;3549805.0
São Paulo;Área 0101;16465;16321;16287;34;144;3549805005001.0
São Paulo;Área 0102;17278;17236;17235;1;42;3549805005002.0
São Paulo;Área 0103;14905;14905;14905;0;0;3549805005003.0
São Paulo;Área 0104;14989;14934;14907;27;55;3549805005004.0
São Paulo;Área 0105;16159;16071;16051;19;88;3549805005005.0
São Paulo;Área 0106;14675;14657;14657;0;18;3549805005006.0
São Paulo;Área 0107;16982;16924;16820;104;58;3549805005007.0
São Paulo;Área 0108;18326;18297;18288;9;29;3549805005008.0
São Paulo;Área 0109;19676;19585;19500;85;91;3549805005009.0
São Paulo;Área 0110;13570;13570;13570;0;0;3549805005010.0
São Paulo;Área 0111;22712;22675;22622;53;37;3549805005011.0
São Paulo;Área 0112;16330;16330;16330;0;0;3549805005012.0
São Paulo;Área 0113;21844;21844;21844;0;0;3549805005013.0
São Paulo;Área 0114;14962;14962;14951;11;0;3549805005014.0
São Paulo;Área 0115;16703;16703;16703;0;0;3549805005015.0
São Paulo;Área 0116;17775;17775;17775;0;0;3549805005016.0
São Paulo;Área 0117;16178;16168;16141;27;10;3549805005017.0
São Paulo;Área 0118;24032;23994;23931;63;38;3549805005018.0
São Paulo;Área 0119;12689;12657;12618;40;32;3549805005019.0
São Paulo;Área 0120;25139;25129;25112;17;10;3549805005020.0
São Paulo;Área 0121;21002;20978;20925;53;24;3549805005021.0
São Paulo;Área 0122;17714;17714;17714;0;0;3549805005022.0
São Paulo;Área 0123;18153;18117;18117;0;36;3549805005023.0
São Paulo;São José dos Campos;629921;627097;626028;1069;2824;3549904.0
São Paulo;Centro 1;41654;41423;41321;102;231;3549904005001.0
São Paulo;Centro 2;30461;30059;29859;201;402;3549904005002.0
São Paulo;Leste 1;57850;57788;57684;104;62;3549904005003.0
São Paulo;Leste 2;45963;45755;45717;38;208;3549904005004.0
São Paulo;Leste 3;57190;57116;57102;14;74;3549904005005.0
São Paulo;Norte 1;52820;52773;52750;23;47;3549904005006.0
São Paulo;Norte 2;19551;19538;19500;38;13;3549904005007.0
São Paulo;Norte 3;2943;2941;2938;2;2;3549904005008.0
São Paulo;Oeste;41163;40467;40168;299;696;3549904005009.0
São Paulo;Sudeste;46194;46133;46115;18;61;3549904005010.0
São Paulo;Sul 1;78256;78093;78093;0;163;3549904005011.0
São Paulo;Sul 2;63877;63464;63381;83;413;3549904005012.0
São Paulo;Sul 3;91999;91548;91401;147;451;3549904005013.0
São Paulo;São Manuel;38342;38314;38304;10;28;3550100.0
São Paulo;Área 001;13577;13568;13568;0;9;3550100003001.0
São Paulo;Área 002;24765;24746;24736;10;19;3550100003002.0
São Paulo;São Miguel Arcanjo;31450;31373;31340;33;77;3550209.0
São Paulo;Área 001;14033;14033;14020;13;0;3550209003001.0
São Paulo;Área 002;17417;17340;17319;20;77;3550209003002.0
São Paulo;São Paulo;11253503;11133776;11102432;31345;119727;3550308.0
São Paulo;Área 001;23651;22793;22714;80;858;3550308005001.0
São Paulo;Área 002;22388;22176;22069;107;212;3550308005002.0
São Paulo;Área 003;34593;32165;31877;288;2428;3550308005003.0
São Paulo;Área 005;33892;29181;28195;986;4711;3550308005004.0
São Paulo;Área 007;29265;27961;27671;289;1304;3550308005005.0
São Paulo;Área 008;36948;36220;36136;85;728;3550308005006.0
São Paulo;Área 010;40400;38977;38334;644;1423;3550308005007.0
São Paulo;Área 012;28692;27250;26897;353;1442;3550308005008.0
São Paulo;Área 013;18606;18221;18075;146;385;3550308005009.0
São Paulo;Área 015;30780;29529;28969;559;1251;3550308005010.0
São Paulo;Área 016;20074;19546;19369;177;528;3550308005011.0
São Paulo;Área 017;28980;28324;27653;671;656;3550308005012.0
São Paulo;Área 019;28385;27354;26824;531;1031;3550308005013.0
São Paulo;Área 022;37841;37227;37034;194;614;3550308005014.0
São Paulo;Área 023;17299;15062;14762;300;2237;3550308005015.0
São Paulo;Área 025;45057;42820;42590;231;2237;3550308005016.0
São Paulo;Área 026;44601;43661;43499;162;940;3550308005017.0
São Paulo;Área 028;31123;30441;30118;323;682;3550308005018.0
São Paulo;Área 029;28899;28383;28272;111;516;3550308005019.0
São Paulo;Área 030;24899;24252;24192;60;647;3550308005020.0
São Paulo;Área 032;36557;35477;35061;416;1080;3550308005021.0
São Paulo;Área 034;23971;22881;22433;448;1090;3550308005022.0
São Paulo;Área 035;26530;25323;24922;401;1207;3550308005023.0
São Paulo;Área 037;31885;30595;30025;570;1290;3550308005024.0
São Paulo;Área 038;30277;29693;29361;332;584;3550308005025.0
São Paulo;Área 041;24829;24506;24190;317;323;3550308005026.0
São Paulo;Área 042;20819;20329;20307;21;490;3550308005027.0
São Paulo;Área 043;25057;23784;23053;732;1273;3550308005028.0
São Paulo;Área 044;14383;14013;13949;63;370;3550308005029.0
São Paulo;Área 046;32495;32137;31924;214;358;3550308005030.0
São Paulo;Área 048;26730;26114;25883;231;616;3550308005031.0
São Paulo;Área 049;27601;26813;26698;115;788;3550308005032.0
São Paulo;Área 050;39870;38453;38339;115;1417;3550308005033.0
São Paulo;Área 051;25820;24529;24457;72;1291;3550308005034.0
São Paulo;Área 054;47773;47325;47192;133;448;3550308005035.0
São Paulo;Área 056;43428;43034;42905;129;394;3550308005036.0
São Paulo;Área 057;25630;24963;24841;123;667;3550308005037.0
São Paulo;Área 058;22614;21991;21902;89;623;3550308005038.0
São Paulo;Área 059;49013;48487;48379;108;526;3550308005039.0
São Paulo;Área 062;47859;47201;47139;63;658;3550308005040.0
São Paulo;Área 063;35950;35412;35284;128;538;3550308005041.0
São Paulo;Área 066;38082;37540;37445;95;542;3550308005042.0
São Paulo;Área 069;32918;32265;32168;96;653;3550308005043.0
São Paulo;Área 070;39661;39130;38788;342;531;3550308005044.0
São Paulo;Área 071;23546;23247;23169;77;299;3550308005045.0
São Paulo;Área 073;45057;43703;43208;494;1354;3550308005046.0
São Paulo;Área 075;43199;42405;42120;285;794;3550308005047.0
São Paulo;Área 076;38331;37293;36989;304;1038;3550308005048.0
São Paulo;Área 077;34036;33121;32792;329;915;3550308005049.0
São Paulo;Área 078;23447;22815;22640;175;632;3550308005050.0
São Paulo;Área 079;20951;20299;19914;385;652;3550308005051.0
São Paulo;Área 080;19795;19522;19342;180;273;3550308005052.0
São Paulo;Área 081;23497;22764;22358;406;733;3550308005053.0
São Paulo;Área 082;22072;21402;21198;203;670;3550308005054.0
São Paulo;Área 083;30428;29906;29733;173;522;3550308005055.0
São Paulo;Área 085;29460;29027;28827;200;433;3550308005056.0
São Paulo;Área 088;26444;26273;26156;116;171;3550308005057.0
São Paulo;Área 089;29203;28599;28359;240;604;3550308005058.0
São Paulo;Área 091;36536;35755;35568;186;781;3550308005059.0
São Paulo;Área 094;40637;40050;39977;73;587;3550308005060.0
São Paulo;Área 095;39592;39137;39018;119;455;3550308005061.0
São Paulo;Área 096;53129;51953;51139;814;1176;3550308005062.0
São Paulo;Área 100;36015;35003;34804;199;1012;3550308005063.0
São Paulo;Área 102;36061;35425;35210;215;636;3550308005064.0
São Paulo;Área 103;46721;45567;45355;212;1154;3550308005065.0
São Paulo;Área 104;35694;34715;34578;137;979;3550308005066.0
São Paulo;Área 107;46467;45259;45025;234;1208;3550308005067.0
São Paulo;Área 108;34191;33529;33449;79;662;3550308005068.0
São Paulo;Área 110;49261;47988;47914;74;1273;3550308005069.0
São Paulo;Área 111;52359;51550;51383;167;809;3550308005070.0
São Paulo;Área 112;33298;32445;32422;23;853;3550308005071.0
São Paulo;Área 114;30678;30233;30065;168;445;3550308005072.0
São Paulo;Área 115;27020;26903;26875;28;117;3550308005073.0
São Paulo;Área 117;39714;39118;38976;141;596;3550308005074.0
São Paulo;Área 118;28172;27827;27668;159;345;3550308005075.0
São Paulo;Área 119;50191;49604;49508;96;587;3550308005076.0
São Paulo;Área 122;41765;41250;41215;35;515;3550308005077.0
São Paulo;Área 124;41516;40651;40603;48;865;3550308005078.0
São Paulo;Área 125;46940;46530;46530;0;410;3550308005079.0
São Paulo;Área 128;43896;43679;43679;0;217;3550308005080.0
São Paulo;Área 130;28503;28214;28199;15;289;3550308005081.0
São Paulo;Área 132;29414;29264;29228;37;150;3550308005082.0
São Paulo;Área 133;36746;36290;36168;122;456;3550308005083.0
São Paulo;Área 134;45048;44711;44630;81;337;3550308005084.0
São Paulo;Área 137;44153;43720;43661;59;433;3550308005085.0
São Paulo;Área 138;45770;45722;45569;153;48;3550308005086.0
São Paulo;Área 139;35461;35132;35111;22;329;3550308005087.0
São Paulo;Área 140;28355;28126;28126;0;229;3550308005088.0
São Paulo;Área 141;40935;40857;40816;42;78;3550308005089.0
São Paulo;Área 142;27364;27231;27231;0;133;3550308005090.0
São Paulo;Área 143;45881;45589;45486;103;292;3550308005091.0
São Paulo;Área 146;22325;21832;21642;190;493;3550308005092.0
São Paulo;Área 147;37773;36751;36751;0;1022;3550308005093.0
São Paulo;Área 148;26925;26198;26030;168;727;3550308005094.0
São Paulo;Área 150;31466;31180;31060;120;286;3550308005095.0
São Paulo;Área 152;28904;28597;28553;44;307;3550308005096.0
São Paulo;Área 153;30463;30238;30217;21;225;3550308005097.0
São Paulo;Área 157;28709;27705;27171;534;1004;3550308005098.0
São Paulo;Área 158;20623;20049;19901;148;574;3550308005099.0
São Paulo;Área 159;39717;38734;38278;456;983;3550308005100.0
São Paulo;Área 160;26035;25349;25138;212;686;3550308005101.0
São Paulo;Área 161;20548;20067;19949;117;481;3550308005102.0
São Paulo;Área 163;27624;26740;26533;208;884;3550308005103.0
São Paulo;Área 165;46957;45822;45336;486;1135;3550308005104.0
São Paulo;Área 166;27284;26514;26286;228;770;3550308005105.0
São Paulo;Área 167;43117;42008;41703;305;1109;3550308005106.0
São Paulo;Área 168;39485;38844;38737;107;641;3550308005107.0
São Paulo;Área 169;49487;49025;48976;49;462;3550308005108.0
São Paulo;Área 171;24895;24607;24589;18;288;3550308005109.0
São Paulo;Área 173;48887;48515;48441;74;372;3550308005110.0
São Paulo;Área 174;35956;35898;35856;42;58;3550308005111.0
São Paulo;Área 176;26713;26580;26546;34;133;3550308005112.0
São Paulo;Área 177;35280;35000;34979;21;280;3550308005113.0
São Paulo;Área 179;38688;38553;38536;17;135;3550308005114.0
São Paulo;Área 181;39066;38893;38696;197;173;3550308005115.0
São Paulo;Área 183;44335;44002;43879;123;333;3550308005116.0
São Paulo;Área 184;29985;29529;29417;112;456;3550308005117.0
São Paulo;Área 185;34431;34027;34027;0;404;3550308005118.0
São Paulo;Área 188;33576;33510;33487;23;66;3550308005119.0
São Paulo;Área 189;45973;45763;45714;49;210;3550308005120.0
São Paulo;Área 191;34661;34404;34386;18;257;3550308005121.0
São Paulo;Área 192;48650;48633;48585;48;17;3550308005122.0
São Paulo;Área 195;46643;46575;46575;0;68;3550308005123.0
São Paulo;Área 196;37893;37114;36969;145;779;3550308005124.0
São Paulo;Área 198;39450;39184;39173;12;266;3550308005125.0
São Paulo;Área 200;35393;35323;35323;0;70;3550308005126.0
São Paulo;Área 201;30787;30530;30485;45;257;3550308005127.0
São Paulo;Área 202;41187;40969;40906;63;218;3550308005128.0
São Paulo;Área 204;35042;34778;34670;108;264;3550308005129.0
São Paulo;Área 205;31351;31066;30995;70;285;3550308005130.0
São Paulo;Área 211;35272;35042;34881;161;230;3550308005131.0
São Paulo;Área 213;27472;27083;26903;180;389;3550308005132.0
São Paulo;Área 216;50094;49198;49094;104;896;3550308005133.0
São Paulo;Área 217;41999;41551;41533;18;448;3550308005134.0
São Paulo;Área 218;54124;53932;53893;39;192;3550308005135.0
São Paulo;Área 219;42250;41925;41903;22;325;3550308005136.0
São Paulo;Área 220;50217;49860;49735;125;357;3550308005137.0
São Paulo;Área 221;28708;28433;28309;124;275;3550308005138.0
São Paulo;Área 223;39009;38968;38968;0;41;3550308005139.0
São Paulo;Área 224;29598;29532;29484;48;66;3550308005140.0
São Paulo;Área 225;31585;31267;31267;0;318;3550308005141.0
São Paulo;Área 227;34130;33935;33707;228;195;3550308005142.0
São Paulo;Área 229;28179;28122;28105;17;57;3550308005143.0
São Paulo;Área 230;27599;27249;27181;68;350;3550308005144.0
São Paulo;Área 231;27209;26813;26741;71;396;3550308005145.0
São Paulo;Área 232;34350;34241;34107;134;109;3550308005146.0
São Paulo;Área 235;26584;26293;26246;47;291;3550308005147.0
São Paulo;Área 236;38732;38630;38584;46;102;3550308005148.0
São Paulo;Área 237;32187;31983;31856;128;204;3550308005149.0
São Paulo;Área 240;51241;50939;50919;20;302;3550308005150.0
São Paulo;Área 242;45930;45618;45606;12;312;3550308005151.0
São Paulo;Área 244;44799;44703;44703;0;96;3550308005152.0
São Paulo;Área 246;43692;43392;43340;51;300;3550308005153.0
São Paulo;Área 249;43790;43547;43547;0;243;3550308005154.0
São Paulo;Área 250;39467;39253;39243;11;214;3550308005155.0
São Paulo;Área 253;48790;48599;48599;0;191;3550308005156.0
São Paulo;Área 254;50712;50712;50678;34;0;3550308005157.0
São Paulo;Área 256;26774;26548;26481;67;226;3550308005158.0
São Paulo;Área 258;43174;43070;43048;22;104;3550308005159.0
São Paulo;Área 259;47203;47153;47153;0;50;3550308005160.0
São Paulo;Área 261;35833;35809;35809;0;24;3550308005161.0
São Paulo;Área 262;28376;28251;28200;52;125;3550308005162.0
São Paulo;Área 264;38219;38101;38101;0;118;3550308005163.0
São Paulo;Área 266;47574;47431;47335;96;143;3550308005164.0
São Paulo;Área 267;48990;48927;48906;21;63;3550308005165.0
São Paulo;Área 268;51178;51007;51007;0;171;3550308005166.0
São Paulo;Área 269;40207;40207;40184;23;0;3550308005167.0
São Paulo;Área 270;38788;38788;38771;17;0;3550308005168.0
São Paulo;Área 272;39944;39493;39382;111;451;3550308005169.0
São Paulo;Área 274;32885;32571;32461;111;314;3550308005170.0
São Paulo;Área 275;29575;29209;29071;138;366;3550308005171.0
São Paulo;Área 277;38253;37369;37103;266;884;3550308005172.0
São Paulo;Área 278;28046;26624;26136;488;1422;3550308005173.0
São Paulo;Área 280;43514;41991;41546;444;1523;3550308005174.0
São Paulo;Área 281;50736;50673;50673;0;63;3550308005175.0
São Paulo;Área 282;44123;42656;42386;270;1467;3550308005176.0
São Paulo;Área 283;32156;31663;31570;93;493;3550308005177.0
São Paulo;Área 284;35134;34202;33971;232;932;3550308005178.0
São Paulo;Área 285;36119;35434;35196;237;685;3550308005179.0
São Paulo;Área 287;26912;25996;25872;124;916;3550308005180.0
São Paulo;Área 288;37188;37057;36933;124;131;3550308005181.0
São Paulo;Área 289;37107;36881;36867;14;226;3550308005182.0
São Paulo;Área 290;32356;31893;31872;21;463;3550308005183.0
São Paulo;Área 291;49372;48687;48483;204;685;3550308005184.0
São Paulo;Área 294;45277;45100;45100;0;177;3550308005185.0
São Paulo;Área 295;33128;32974;32855;119;154;3550308005186.0
São Paulo;Área 296;30854;30675;30660;16;179;3550308005187.0
São Paulo;Área 297;40899;40888;40873;15;11;3550308005188.0
São Paulo;Área 299;55739;55626;55556;71;113;3550308005189.0
São Paulo;Área 300;33252;33158;33158;0;94;3550308005190.0
São Paulo;Área 301;51041;50488;50473;16;553;3550308005191.0
São Paulo;Área 303;45008;44790;44741;49;218;3550308005192.0
São Paulo;Área 304;50229;49903;49787;116;326;3550308005193.0
São Paulo;Área 306;47431;47388;47367;21;43;3550308005194.0
São Paulo;Área 307;44712;44229;44172;57;483;3550308005195.0
São Paulo;Área 311;39360;39237;39214;22;123;3550308005196.0
São Paulo;Área 313;52721;52559;52539;20;162;3550308005197.0
São Paulo;Área 314;42551;42306;42243;63;245;3550308005198.0
São Paulo;Área 317;45357;45286;45286;0;71;3550308005199.0
São Paulo;Área 318;36007;35935;35915;20;72;3550308005200.0
São Paulo;Área 322;47529;47453;47387;67;76;3550308005201.0
São Paulo;Área 323;33427;33362;33346;16;65;3550308005202.0
São Paulo;Área 324;30557;30535;30512;23;22;3550308005203.0
São Paulo;Área 325;37388;37143;37143;0;245;3550308005204.0
São Paulo;Área 326;30870;30830;30830;0;40;3550308005205.0
São Paulo;Área 329;31381;31289;31269;19;92;3550308005206.0
São Paulo;Área 330;35473;35450;35384;66;23;3550308005207.0
São Paulo;Área 331;44496;44320;44260;59;176;3550308005208.0
São Paulo;Área 332;29591;29576;29576;0;15;3550308005209.0
São Paulo;Área 333;32928;32895;32895;0;33;3550308005210.0
São Paulo;Área 334;30217;30096;30062;34;121;3550308005211.0
São Paulo;Área 336;46563;46322;46303;19;241;3550308005212.0
São Paulo;Área 337;40141;39944;39886;58;197;3550308005213.0
São Paulo;Área 338;41407;41394;41394;0;13;3550308005214.0
São Paulo;Área 339;34086;34050;34050;0;36;3550308005215.0
São Paulo;Área 341;28683;28683;28683;0;0;3550308005216.0
São Paulo;Área 342;45732;45552;45522;30;180;3550308005217.0
São Paulo;Área 344;34960;34902;34902;0;58;3550308005218.0
São Paulo;Área 346;33474;33119;33083;36;355;3550308005219.0
São Paulo;Área 348;37783;37151;36943;207;632;3550308005220.0
São Paulo;Área 350;45129;44996;44977;19;133;3550308005221.0
São Paulo;Área 351;31640;31577;31577;0;63;3550308005222.0
São Paulo;Área 354;29817;29797;29797;0;20;3550308005223.0
São Paulo;Área 356;45546;45468;45468;0;78;3550308005224.0
São Paulo;Área 357;40686;40646;40631;14;40;3550308005225.0
São Paulo;Área 358;40744;40659;40638;21;85;3550308005226.0
São Paulo;Área 360;37123;37105;37083;22;18;3550308005227.0
São Paulo;Área 362;28321;28238;28221;17;83;3550308005228.0
São Paulo;Área 363;46732;46685;46643;41;47;3550308005229.0
São Paulo;Área 364;49861;49752;49752;0;109;3550308005230.0
São Paulo;Área 365;46059;45848;45819;30;211;3550308005231.0
São Paulo;Área 366;28574;28552;28552;0;22;3550308005232.0
São Paulo;Área 367;35523;35483;35483;0;40;3550308005233.0
São Paulo;Área 369;43059;42779;42680;99;280;3550308005234.0
São Paulo;Área 371;38054;37791;37708;83;263;3550308005235.0
São Paulo;Área 372;41359;41302;41278;24;57;3550308005236.0
São Paulo;Área 374;53366;53215;53105;111;151;3550308005237.0
São Paulo;Área 375;37967;37691;37632;60;276;3550308005238.0
São Paulo;Área 376;29768;29633;29592;41;135;3550308005239.0
São Paulo;Área 377;32429;32259;32242;16;170;3550308005240.0
São Paulo;Área 379;29456;29376;29376;0;80;3550308005241.0
São Paulo;Área 381;37213;37144;37144;0;69;3550308005242.0
São Paulo;Área 383;42974;42883;42883;0;91;3550308005243.0
São Paulo;Área 384;36520;36499;36499;0;21;3550308005244.0
São Paulo;Área 385;32348;32305;32305;0;43;3550308005245.0
São Paulo;Área 386;33318;33194;33194;0;124;3550308005246.0
São Paulo;Área 388;32857;32839;32839;0;18;3550308005247.0
São Paulo;Área 391;48915;48755;48755;0;160;3550308005248.0
São Paulo;Área 393;44492;44421;44421;0;71;3550308005249.0
São Paulo;Área 394;29750;29670;29670;0;80;3550308005250.0
São Paulo;Área 395;44469;44469;44469;0;0;3550308005251.0
São Paulo;Área 398;49773;49730;49684;45;43;3550308005252.0
São Paulo;Área 399;50365;50133;50098;35;232;3550308005253.0
São Paulo;Área 400;42599;42599;42599;0;0;3550308005254.0
São Paulo;Área 401;30713;30592;30592;0;121;3550308005255.0
São Paulo;Área 402;32051;32051;32051;0;0;3550308005256.0
São Paulo;Área 403;29886;29845;29816;28;41;3550308005257.0
São Paulo;Área 404;30247;30165;30165;0;82;3550308005258.0
São Paulo;Área 406;56989;56858;56858;0;131;3550308005259.0
São Paulo;Área 408;47390;47135;47079;56;255;3550308005260.0
São Paulo;Área 409;36815;36721;36697;24;94;3550308005261.0
São Paulo;Área 410;27341;27261;27261;0;80;3550308005262.0
São Paulo;Área 411;25828;25750;25731;19;78;3550308005263.0
São Paulo;Área 412;31205;31205;31205;0;0;3550308005264.0
São Paulo;Área 413;28095;27914;27914;0;181;3550308005265.0
São Paulo;Área 414;44696;44652;44652;0;44;3550308005266.0
São Paulo;Área 416;34138;34138;34112;26;0;3550308005267.0
São Paulo;Área 417;42877;42776;42776;0;101;3550308005268.0
São Paulo;Área 418;29765;29709;29654;55;56;3550308005269.0
São Paulo;Área 420;38325;38325;38325;0;0;3550308005270.0
São Paulo;Área 421;30848;30848;30848;0;0;3550308005271.0
São Paulo;Área 422;38673;38655;38655;0;18;3550308005272.0
São Paulo;Área 423;31013;30923;30912;11;90;3550308005273.0
São Paulo;Área 424;29057;28997;28997;0;60;3550308005274.0
São Paulo;Área 425;34217;34183;34183;0;34;3550308005275.0
São Paulo;Área 426;34056;34025;34025;0;31;3550308005276.0
São Paulo;Área 427;35975;35975;35951;24;0;3550308005277.0
São Paulo;Área 428;31237;31215;31194;22;22;3550308005278.0
São Paulo;Área 429;32088;32016;31990;26;72;3550308005279.0
São Paulo;Área 430;55321;55249;55235;14;72;3550308005280.0
São Paulo;Área 432;29088;29088;29041;47;0;3550308005281.0
São Paulo;Área 433;37312;37290;37290;0;22;3550308005282.0
São Paulo;Área 434;52952;52625;52566;60;327;3550308005283.0
São Paulo;Área 435;45980;45980;45980;0;0;3550308005284.0
São Paulo;Área 437;44564;44531;44519;13;33;3550308005285.0
São Paulo;Área 439;33347;33263;33240;23;84;3550308005286.0
São Paulo;Área 440;48847;48190;48125;65;657;3550308005287.0
São Paulo;Área 441;30497;30497;30475;22;0;3550308005288.0
São Paulo;Área 442;30152;30152;30152;0;0;3550308005289.0
São Paulo;Área 443;32966;32966;32966;0;0;3550308005290.0
São Paulo;Área 444;41295;41274;41204;70;21;3550308005291.0
São Paulo;Área 446;43382;43382;43360;22;0;3550308005292.0
São Paulo;Área 447;39275;39275;39275;0;0;3550308005293.0
São Paulo;Área 449;30664;30596;30596;0;68;3550308005294.0
São Paulo;Área 450;33438;33419;33419;0;19;3550308005295.0
São Paulo;Área 451;50889;50872;50848;24;17;3550308005296.0
São Paulo;Área 454;29244;29141;29141;0;103;3550308005297.0
São Paulo;Área 455;8258;8251;8251;0;7;3550308005298.0
São Paulo;Área 456;28891;28784;28784;0;107;3550308005299.0
São Paulo;Área 457;36158;36008;36008;0;150;3550308005300.0
São Paulo;Área 458;32139;32061;32061;0;78;3550308005301.0
São Paulo;Área 459;33995;33975;33975;0;20;3550308005302.0
São Paulo;Área 460;29560;29560;29560;0;0;3550308005303.0
São Paulo;Área 461;33922;33922;33899;23;0;3550308005304.0
São Paulo;Área 462;25813;25508;25490;17;305;3550308005305.0
São Paulo;Área 463;30332;30308;30292;17;24;3550308005306.0
São Paulo;Área 465;36403;36357;36357;0;46;3550308005307.0
São Paulo;Área 466;28579;28073;27954;119;506;3550308005308.0
São Paulo;Área 467;34660;34660;34660;0;0;3550308005309.0
São Paulo;Área 468;28184;27927;27863;64;257;3550308005310.0
São Paulo;São Pedro;31662;31592;31563;29;70;3550407.0
São Paulo;Área 001;14295;14254;14245;9;41;3550407003001.0
São Paulo;Área 002;17367;17337;17318;19;30;3550407003002.0
São Paulo;São Roque;78821;78387;78270;117;434;3550605.0
São Paulo;Área 001;16708;16567;16525;42;141;3550605003001.0
São Paulo;Área 002;28387;28258;28230;28;129;3550605003002.0
São Paulo;Área 003;33726;33562;33515;47;164;3550605003003.0
São Paulo;São Sebastião;73942;73689;73527;162;253;3550704.0
São Paulo;Área 001;14527;14468;14468;0;59;3550704003001.0
São Paulo;Área 002;14728;14644;14566;78;84;3550704003002.0
São Paulo;Área 003;13503;13476;13434;42;27;3550704003003.0
São Paulo;Área 004;31184;31102;31059;42;82;3550704003004.0
São Paulo;São Vicente;332445;330820;330345;475;1625;3551009.0
São Paulo;Área 001;35475;35390;35370;19;85;3551009005001.0
São Paulo;Área 002;24796;24750;24703;47;46;3551009005002.0
São Paulo;Área 003;39573;38869;38692;177;704;3551009005003.0
São Paulo;Área 004;34856;34739;34717;22;117;3551009005004.0
São Paulo;Área 005;26442;26349;26324;25;93;3551009005005.0
São Paulo;Área 006;27554;27530;27506;24;24;3551009005006.0
São Paulo;Área 007;25126;24910;24860;50;216;3551009005007.0
São Paulo;Área 008;20463;20136;20057;79;327;3551009005008.0
São Paulo;Área 009;27075;27063;27053;10;12;3551009005009.0
São Paulo;Área 010;39956;39956;39942;14;0;3551009005010.0
São Paulo;Área 011;31129;31129;31121;8;0;3551009005011.0
São Paulo;Serrana;38878;38866;38855;11;12;3551504.0
São Paulo;Área 001;16674;16662;16662;0;12;3551504003001.0
São Paulo;Área 002;22204;22204;22193;11;0;3551504003002.0
São Paulo;Sertãozinho;110074;110023;109984;38;51;3551702.0
São Paulo;Área 001;12740;12718;12718;0;22;3551702003001.0
São Paulo;Área 002;17385;17375;17375;0;10;3551702003002.0
São Paulo;Área 003;15194;15194;15194;0;0;3551702003003.0
São Paulo;Área 004;13268;13268;13255;13;0;3551702003004.0
São Paulo;Área 005;28599;28580;28580;0;19;3551702003005.0
São Paulo;Área 006;22888;22888;22863;25;0;3551702003006.0
São Paulo;Socorro;36686;36627;36619;7;59;3552106.0
São Paulo;Área 001;18236;18236;18236;0;0;3552106003001.0
São Paulo;Área 002;18450;18391;18383;7;59;3552106003002.0
São Paulo;Sorocaba;586625;585142;584694;448;1483;3552205.0
São Paulo;Macro Barcelona;26432;26419;26419;0;13;3552205005015.0
São Paulo;Macro Campolim;26154;26060;25976;84;94;3552205005005.0
São Paulo;Macro Central Parque-Jardim São Paulo;30236;29888;29824;65;348;3552205005001.0
São Paulo;Macro Centro;27147;26834;26716;118;313;3552205005010.0
São Paulo;Macro Éden-Ibiti;28254;28180;28180;0;74;3552205005018.0
São Paulo;Macro Fiori-Brasilândia;34560;34493;34473;20;67;3552205005012.0
São Paulo;Macro Formosa;33620;33564;33564;0;56;3552205005013.0
São Paulo;Macro Laranjeiras-Habiteto;38345;38329;38309;20;16;3552205005009.0
São Paulo;Macro Leste;26474;26318;26305;13;156;3552205005017.0
São Paulo;Macro Nordeste;31038;30998;30982;16;40;3552205005019.0
São Paulo;Macro Nova Sorocaba;33602;33574;33553;21;28;3552205005008.0
São Paulo;Macro Parque São Bento;33443;33421;33421;0;22;3552205005004.0
São Paulo;Macro Santa Rosália;29792;29724;29666;57;68;3552205005011.0
São Paulo;Macro Simus;27780;27611;27599;12;169;3552205005006.0
São Paulo;Macro Sorocaba I;33535;33535;33535;0;0;3552205005002.0
São Paulo;Macro Vila Helena;44636;44636;44636;0;0;3552205005007.0
São Paulo;Macro Vila Hortência;24534;24513;24492;21;21;3552205005016.0
São Paulo;Macro Vitória Régia;30224;30224;30224;0;0;3552205005014.0
São Paulo;Macro Wanel Ville;26819;26819;26819;0;0;3552205005003.0
São Paulo;Sumaré;241311;241006;240929;77;305;3552403.0
São Paulo;Área Cura 1;16092;16092;16092;0;0;3552403005001.0
São Paulo;Área Cura 2;19211;19187;19177;11;24;3552403005002.0
São Paulo;Área Cura 3;15950;15939;15928;11;11;3552403005003.0
São Paulo;Centro 1;14234;14216;14199;17;18;3552403005004.0
São Paulo;Centro 2;15478;15469;15469;0;9;3552403005005.0
São Paulo;Centro 3;13130;13048;13039;8;82;3552403005006.0
São Paulo;Maria Antonia 1;17795;17795;17795;0;0;3552403005007.0
São Paulo;Maria Antonia 2;20598;20589;20589;0;9;3552403005008.0
São Paulo;Matão 1;16343;16301;16280;22;42;3552403005009.0
São Paulo;Matão 2;20331;20331;20331;0;0;3552403005010.0
São Paulo;Nova Veneza 1;14454;14454;14454;0;0;3552403005011.0
São Paulo;Nova Veneza 2;13559;13540;13531;9;19;3552403005012.0
São Paulo;Nova Veneza 3;12299;12237;12237;0;62;3552403005013.0
São Paulo;Picerno 1;15261;15251;15251;0;10;3552403005014.0
São Paulo;Picerno 2;16576;16557;16557;0;19;3552403005015.0
São Paulo;Suzano;262480;261382;260978;404;1098;3552502.0
São Paulo;Boa Vista Paulista;82811;82735;82725;10;76;3552502005002.0
São Paulo;Palmeiras de São Paulo;23865;23811;23744;67;54;3552502005003.0
São Paulo;Suzano;155804;154836;154509;327;968;3552502005001.0
São Paulo;Taboão da Serra;244528;243903;243669;233;625;3552809.0
São Paulo;Área 001;20024;19931;19906;24;93;3552809005001.0
São Paulo;Área 002;17599;17453;17422;30;146;3552809005002.0
São Paulo;Área 003;21435;21238;21133;106;197;3552809005003.0
São Paulo;Área 004;22605;22539;22539;0;66;3552809005004.0
São Paulo;Área 005;18151;18113;18090;22;38;3552809005005.0
São Paulo;Área 006;29596;29547;29515;32;49;3552809005006.0
São Paulo;Área 007;33697;33677;33668;9;20;3552809005007.0
São Paulo;Área 008;41407;41398;41389;10;9;3552809005008.0
São Paulo;Área 009;26031;26023;26023;0;8;3552809005009.0
São Paulo;Área 010;13983;13983;13983;0;0;3552809005010.0
São Paulo;Taquaritinga;53988;53922;53832;90;66;3553708.0
São Paulo;Área 001;14538;14538;14538;0;0;3553708003001.0
São Paulo;Área 002;19918;19907;19840;67;11;3553708003002.0
São Paulo;Área 003;19532;19477;19454;23;55;3553708003003.0
São Paulo;Tatuí;107326;107083;107008;75;243;3554003.0
São Paulo;Área 001;14268;14253;14245;8;15;3554003003001.0
São Paulo;Área 002;33723;33672;33635;36;51;3554003003002.0
São Paulo;Área 003;28733;28665;28655;10;68;3554003003003.0
São Paulo;Área 004;30602;30494;30473;21;108;3554003003004.0
São Paulo;Taubaté;278686;278003;277844;159;683;3554102.0
São Paulo;Área 001;13180;13171;13171;0;9;3554102003001.0
São Paulo;Área 002;19919;19897;19885;12;22;3554102003002.0
São Paulo;Área 003;14652;14652;14652;0;0;3554102003003.0
São Paulo;Área 004;15058;15035;15035;0;23;3554102003004.0
São Paulo;Área 005;14629;14579;14579;0;50;3554102003005.0
São Paulo;Área 006;15336;15336;15336;0;0;3554102003006.0
São Paulo;Área 007;13959;13959;13941;18;0;3554102003007.0
São Paulo;Área 008;15705;15705;15705;0;0;3554102003008.0
São Paulo;Área 009;18831;18774;18764;10;57;3554102003009.0
São Paulo;Área 010;20037;19970;19953;17;67;3554102003010.0
São Paulo;Área 011;45067;44945;44909;36;122;3554102003011.0
São Paulo;Área 012;15399;15321;15298;23;78;3554102003012.0
São Paulo;Área 013;24999;24774;24731;43;225;3554102003013.0
São Paulo;Área 014;31915;31886;31886;0;29;3554102003014.0
São Paulo;Tietê;36835;36807;36743;64;28;3554508.0
São Paulo;Área 001;17498;17470;17418;52;28;3554508003001.0
São Paulo;Área 002;19337;19337;19325;12;0;3554508003002.0
São Paulo;Tremembé;40984;40977;40952;25;7;3554805.0
São Paulo;Área 001;18581;18581;18566;15;0;3554805003001.0
São Paulo;Área 002;22403;22396;22387;9;7;3554805003002.0
São Paulo;Tupã;63476;63345;63217;128;131;3555000.0
São Paulo;Área 001;12055;12011;11992;19;44;3555000003001.0
São Paulo;Área 002;24354;24325;24291;35;29;3555000003002.0
São Paulo;Área 003;27067;27008;26934;74;59;3555000003003.0
São Paulo;Ubatuba;78801;78512;78455;57;289;3555406.0
São Paulo;Área 001;14176;14144;14134;10;32;3555406003001.0
São Paulo;Área 002;17995;17961;17950;11;34;3555406003002.0
São Paulo;Área 003;18719;18534;18507;27;185;3555406003003.0
São Paulo;Área 004;27911;27872;27863;9;39;3555406003004.0
São Paulo;Valinhos;106793;106276;106099;177;517;3556206.0
São Paulo;Área 001;18525;18516;18504;12;9;3556206003001.0
São Paulo;Área 002;21269;21216;21210;6;53;3556206003002.0
São Paulo;Área 003;18581;18491;18458;32;90;3556206003003.0
São Paulo;Área 004;24150;24001;23940;61;149;3556206003004.0
São Paulo;Área 005;24268;24053;23987;66;215;3556206003005.0
São Paulo;Vargem Grande do Sul;39266;39266;39238;28;0;3556404.0
São Paulo;Área 001;14985;14985;14985;0;0;3556404003001.0
São Paulo;Área 002;24281;24281;24253;28;0;3556404003002.0
São Paulo;Vargem Grande Paulista;42997;42795;42738;58;202;3556453.0
São Paulo;Área 001;21013;20891;20866;25;122;3556453003001.0
São Paulo;Área 002;21984;21905;21872;33;79;3556453003002.0
São Paulo;Várzea Paulista;107089;107047;107030;17;42;3556503.0
São Paulo;Área 001;15080;15080;15080;0;0;3556503003001.0
São Paulo;Área 002;16708;16708;16708;0;0;3556503003002.0
São Paulo;Área 003;29799;29787;29787;0;12;3556503003003.0
São Paulo;Área 004;45502;45471;45454;17;31;3556503003004.0
São Paulo;Vinhedo;63611;62945;62823;122;666;3556701.0
São Paulo;Área 001;13745;13466;13398;68;279;3556701003001.0
São Paulo;Área 002;22303;22136;22132;4;167;3556701003002.0
São Paulo;Área 003;27563;27343;27293;49;220;3556701003003.0
São Paulo;Votorantim;108809;108749;108706;44;60;3557006.0
São Paulo;Área 001;15408;15369;15369;0;39;3557006003001.0
São Paulo;Área 002;15159;15159;15150;9;0;3557006003002.0
São Paulo;Área 003;15898;15898;15898;0;0;3557006003003.0
São Paulo;Área 004;15218;15218;15195;23;0;3557006003004.0
São Paulo;Área 005;20744;20733;20720;12;11;3557006003005.0
São Paulo;Área 006;26382;26373;26373;0;9;3557006003006.0
São Paulo;Votuporanga;84692;84552;84443;109;140;3557105.0
São Paulo;Área 001;12393;12361;12328;33;32;3557105003001.0
São Paulo;Área 002;11641;11641;11620;21;0;3557105003002.0
São Paulo;Área 003;17906;17894;17885;8;12;3557105003003.0
São Paulo;Área 004;20807;20762;20762;0;45;3557105003004.0
São Paulo;Área 005;21945;21894;21848;46;51;3557105003005.0
Paraná;Almirante Tamandaré;103204;103137;103084;53;67;4100400.0
Paraná;Área 001;15567;15567;15559;8;0;4100400003001.0
Paraná;Área 002;17909;17898;17886;12;11;4100400003002.0
Paraná;Área 003;35050;35031;35031;0;19;4100400003003.0
Paraná;Área 004;34678;34641;34608;33;37;4100400003004.0
Paraná;Apucarana;120919;120716;120519;197;203;4101408.0
Paraná;Área 001;13176;13142;13119;23;34;4101408003001.0
Paraná;Área 002;14402;14347;14289;58;55;4101408003002.0
Paraná;Área 003;14107;14107;14071;36;0;4101408003003.0
Paraná;Área 004;13822;13796;13788;8;26;4101408003004.0
Paraná;Área 005;13883;13870;13870;0;13;4101408003005.0
Paraná;Área 006;20612;20569;20554;15;43;4101408003006.0
Paraná;Área 007;30917;30885;30828;57;32;4101408003007.0
Paraná;Arapongas;104150;103928;103808;120;222;4101507.0
Paraná;Área 001;13264;13235;13222;13;29;4101507003001.0
Paraná;Área 002;14697;14638;14638;0;59;4101507003002.0
Paraná;Área 003;13366;13345;13330;15;21;4101507003003.0
Paraná;Área 004;20096;20076;20040;36;20;4101507003004.0
Paraná;Área 005;19986;19923;19887;36;63;4101507003005.0
Paraná;Área 006;22741;22710;22691;19;31;4101507003006.0
Paraná;Araucária;119123;119036;118946;90;87;4101804.0
Paraná;Área 001;17880;17866;17866;0;14;4101804003001.0
Paraná;Área 002;15073;15051;15051;0;22;4101804003002.0
Paraná;Área 003;16126;16115;16106;9;11;4101804003003.0
Paraná;Área 004;18859;18851;18804;47;8;4101804003004.0
Paraná;Área 005;23757;23736;23724;12;21;4101804003005.0
Paraná;Área 006;27428;27416;27394;22;12;4101804003006.0
Paraná;Assis Chateaubriand;33025;32955;32891;64;70;4102000.0
Paraná;Área 001;13656;13631;13598;33;25;4102000003001.0
Paraná;Área 002;19369;19324;19293;31;45;4102000003002.0
Paraná;Bandeirantes;32184;32135;32108;27;49;4102406.0
Paraná;Área 001;14674;14674;14674;0;0;4102406003001.0
Paraná;Área 002;17510;17461;17434;27;49;4102406003002.0
Paraná;Cambé;96733;96679;96591;88;54;4103701.0
Paraná;Área 001;12701;12694;12694;0;7;4103701003001.0
Paraná;Área 002;13084;13084;13061;23;0;4103701003002.0
Paraná;Área 003;13622;13613;13613;0;9;4103701003003.0
Paraná;Área 004;28202;28191;28165;26;11;4103701003004.0
Paraná;Área 005;29124;29098;29059;39;26;4103701003005.0
Paraná;Campina Grande do Sul;38769;38737;38737;0;32;4104006.0
Paraná;Área 001;14790;14781;14781;0;9;4104006003001.0
Paraná;Área 002;23979;23956;23956;0;23;4104006003002.0
Paraná;Campo Largo;112377;112342;112234;108;35;4104204.0
Paraná;Área 001;12823;12823;12823;0;0;4104204003001.0
Paraná;Área 002;26900;26865;26802;63;35;4104204003002.0
Paraná;Área 003;16465;16465;16428;37;0;4104204003003.0
Paraná;Área 004;27513;27513;27505;8;0;4104204003004.0
Paraná;Área 005;28676;28676;28676;0;0;4104204003005.0
Paraná;Campo Mourão;87194;87096;87011;85;98;4104303.0
Paraná;Área 001;12772;12750;12739;11;22;4104303003001.0
Paraná;Área 002;13004;12984;12968;16;20;4104303003002.0
Paraná;Área 003;15262;15257;15257;0;5;4104303003003.0
Paraná;Área 004;15645;15629;15580;50;16;4104303003004.0
Paraná;Área 005;30511;30475;30467;8;36;4104303003005.0
Paraná;Cascavel;286205;285523;284717;806;682;4104808.0
Paraná;Área 001;13447;13390;13359;30;57;4104808005001.0
Paraná;Área 002;14432;14413;14363;49;19;4104808005002.0
Paraná;Área 003;12735;12705;12635;70;30;4104808005003.0
Paraná;Área 004;13392;13366;13336;30;26;4104808005004.0
Paraná;Área 005;16493;16419;16366;54;74;4104808005005.0
Paraná;Área 006;15466;15430;15394;36;36;4104808005006.0
Paraná;Área 007;14897;14875;14861;14;22;4104808005007.0
Paraná;Área 008;15861;15843;15814;28;18;4104808005008.0
Paraná;Área 009;16360;16308;16269;40;52;4104808005009.0
Paraná;Área 010;13577;13561;13546;15;16;4104808005010.0
Paraná;Área 011;15559;15539;15506;33;20;4104808005011.0
Paraná;Área 012;18723;18650;18564;86;73;4104808005012.0
Paraná;Área 013;24534;24392;24341;51;142;4104808005013.0
Paraná;Área 014;17634;17619;17534;85;15;4104808005014.0
Paraná;Área 015;19521;19477;19435;42;44;4104808005015.0
Paraná;Área 016;24204;24175;24119;56;29;4104808005016.0
Paraná;Área 017;19370;19360;19275;85;10;4104808005017.0
Paraná;Castro;67084;66931;66845;86;153;4104907.0
Paraná;Área 001;15816;15711;15690;21;105;4104907003001.0
Paraná;Área 002;24367;24341;24306;35;26;4104907003002.0
Paraná;Área 003;26901;26879;26849;30;22;4104907003003.0
Paraná;Cianorte;69958;69771;69627;143;187;4105508.0
Paraná;Área 001;13792;13705;13651;54;87;4105508003001.0
Paraná;Área 002;13047;12987;12972;15;60;4105508003002.0
Paraná;Área 003;17905;17884;17852;32;21;4105508003003.0
Paraná;Área 004;25214;25194;25152;42;20;4105508003004.0
Paraná;Colombo;212967;212746;212438;308;221;4105805.0
Paraná;Campo Pequeno;20189;20156;20132;24;33;4105805005001.0
Paraná;Centro;31106;31078;31023;55;28;4105805005002.0
Paraná;Das Graças;14498;14488;14411;77;10;4105805005003.0
Paraná;Guabirotuba;22233;22212;22204;9;21;4105805005004.0
Paraná;Guarani;24609;24585;24574;11;24;4105805005005.0
Paraná;Maracanã;14849;14849;14829;20;0;4105805005006.0
Paraná;Palmital;14653;14636;14578;57;17;4105805005007.0
Paraná;Paloma;16938;16891;16891;0;47;4105805005008.0
Paraná;Rio Verde;22988;22959;22926;34;29;4105805005009.0
Paraná;São Dimas;13774;13766;13766;0;8;4105805005010.0
Paraná;São Gabriel;17130;17125;17103;22;5;4105805005011.0
Paraná;Cornélio Procópio;46928;46889;46800;89;39;4106407.0
Paraná;Área 001;20960;20931;20850;81;29;4106407003001.0
Paraná;Área 002;25968;25958;25950;8;10;4106407003002.0
Paraná;Curitiba;1751907;1743036;1738747;4289;8871;4106902.0
Paraná;Área 001;25627;25401;25251;150;226;4106902005001.0
Paraná;Área 002;39214;38210;37960;250;1004;4106902005002.0
Paraná;Área 003;17393;16974;16696;278;419;4106902005003.0
Paraná;Área 004;30053;29985;29919;66;68;4106902005004.0
Paraná;Área 005;21913;21803;21685;117;110;4106902005005.0
Paraná;Área 006;24566;24400;24374;26;166;4106902005006.0
Paraná;Área 007;27557;27496;27479;17;61;4106902005007.0
Paraná;Área 008;31052;30761;30655;106;291;4106902005008.0
Paraná;Área 009;35392;34980;34913;67;412;4106902005009.0
Paraná;Área 010;25488;25488;25465;23;0;4106902005010.0
Paraná;Área 011;32808;32734;32718;16;74;4106902005011.0
Paraná;Área 012;28254;28172;28058;114;82;4106902005012.0
Paraná;Área 013;23734;23631;23491;140;103;4106902005013.0
Paraná;Área 014;37588;36972;36668;303;616;4106902005014.0
Paraná;Área 015;46106;46024;45979;45;82;4106902005015.0
Paraná;Área 016;28545;28375;28183;192;170;4106902005016.0
Paraná;Área 017;36986;36652;36448;204;334;4106902005017.0
Paraná;Área 018;32519;32283;32135;148;236;4106902005018.0
Paraná;Área 019;26774;26609;26521;88;165;4106902005019.0
Paraná;Área 020;32627;32627;32601;26;0;4106902005020.0
Paraná;Área 021;30880;30795;30699;95;85;4106902005021.0
Paraná;Área 022;32693;32444;32388;57;249;4106902005022.0
Paraná;Área 023;35938;35853;35820;33;85;4106902005023.0
Paraná;Área 024;36118;35985;35883;102;133;4106902005024.0
Paraná;Área 025;32724;32661;32622;39;63;4106902005025.0
Paraná;Área 026;31903;31759;31710;49;144;4106902005026.0
Paraná;Área 027;27597;27446;27446;0;151;4106902005027.0
Paraná;Área 028;29193;29183;29172;10;10;4106902005028.0
Paraná;Área 029;24838;24721;24721;0;117;4106902005029.0
Paraná;Área 030;23129;22820;22652;168;309;4106902005030.0
Paraná;Área 031;28296;28020;27889;130;276;4106902005031.0
Paraná;Área 032;32029;31893;31858;35;136;4106902005032.0
Paraná;Área 033;27989;27917;27898;19;72;4106902005033.0
Paraná;Área 034;25509;25021;24727;294;488;4106902005034.0
Paraná;Área 035;24061;23759;23596;164;302;4106902005035.0
Paraná;Área 036;42035;41871;41731;141;164;4106902005036.0
Paraná;Área 037;29067;28950;28896;55;117;4106902005037.0
Paraná;Área 038;28074;28054;28054;0;20;4106902005038.0
Paraná;Área 039;44063;43750;43705;45;313;4106902005039.0
Paraná;Área 040;36065;35969;35902;67;96;4106902005040.0
Paraná;Área 041;52780;52780;52780;0;0;4106902005041.0
Paraná;Área 042;29908;29891;29852;39;17;4106902005042.0
Paraná;Área 043;29179;29156;29122;35;23;4106902005043.0
Paraná;Área 044;46198;46141;46141;0;57;4106902005044.0
Paraná;Área 045;30361;30361;30340;21;0;4106902005045.0
Paraná;Área 046;38966;38966;38949;17;0;4106902005046.0
Paraná;Área 047;50401;50337;50337;0;64;4106902005047.0
Paraná;Área 048;33210;33155;33124;31;55;4106902005048.0
Paraná;Área 049;34901;34838;34838;0;63;4106902005049.0
Paraná;Área 050;44005;44005;44005;0;0;4106902005050.0
Paraná;Área 051;33923;33920;33855;65;3;4106902005051.0
Paraná;Área 052;26783;26762;26762;0;21;4106902005052.0
Paraná;Área 053;19890;19415;19287;128;475;4106902005053.0
Paraná;Área 054;28833;28809;28737;72;24;4106902005054.0
Paraná;Área 055;26172;26051;26051;0;121;4106902005055.0
Paraná;Dois Vizinhos;36179;36167;36146;22;12;4107207.0
Paraná;Área 001;12155;12155;12141;14;0;4107207003001.0
Paraná;Área 002;24024;24012;24005;7;12;4107207003002.0
Paraná;Fazenda Rio Grande;81675;81651;81576;75;24;4107652.0
Paraná;Área 001;14303;14303;14293;10;0;4107652003001.0
Paraná;Área 002;13583;13570;13570;0;13;4107652003002.0
Paraná;Área 003;26751;26741;26675;65;10;4107652003003.0
Paraná;Área 004;27038;27038;27038;0;0;4107652003004.0
Paraná;Foz do Iguaçu;256088;250341;247317;3024;5747;4108304.0
Paraná;Área 001;13297;13190;13070;120;107;4108304003001.0
Paraná;Área 002;13708;13602;13427;175;106;4108304003002.0
Paraná;Área 003;14348;14205;14099;106;143;4108304003003.0
Paraná;Área 004;14336;14189;14055;134;147;4108304003004.0
Paraná;Área 005;92138;91083;90250;833;1055;4108304003005.0
Paraná;Área 006;14910;14703;14599;104;207;4108304003006.0
Paraná;Área 007;13157;12800;12706;93;357;4108304003007.0
Paraná;Área 008;16778;16458;16311;146;320;4108304003008.0
Paraná;Área 009;17527;17203;16975;228;324;4108304003009.0
Paraná;Área 010;22776;20788;20079;709;1988;4108304003010.0
Paraná;Área 011;23113;22120;21744;376;993;4108304003011.0
Paraná;Francisco Beltrão;78943;78791;78679;112;152;4108403.0
Paraná;Área 001;12655;12639;12639;0;16;4108403003001.0
Paraná;Área 002;15717;15672;15606;66;45;4108403003002.0
Paraná;Área 003;13074;13037;13028;9;37;4108403003003.0
Paraná;Área 004;15296;15252;15242;10;44;4108403003004.0
Paraná;Área 005;22201;22190;22163;27;11;4108403003005.0
Paraná;Goioerê;29018;28971;28891;80;47;4108601.0
Paraná;Área 001;12521;12494;12485;9;27;4108601003001.0
Paraná;Área 002;16497;16476;16405;71;21;4108601003002.0
Paraná;Guaíra;30704;30264;29995;269;440;4108809.0
Paraná;Área 001;13461;13195;13154;41;266;4108809003001.0
Paraná;Área 002;17243;17070;16841;228;173;4108809003002.0
Paraná;Guarapuava;167328;167198;166806;392;130;4109401.0
Paraná;Área 001;13576;13551;13301;250;25;4109401003001.0
Paraná;Área 002;15251;15241;15241;0;10;4109401003002.0
Paraná;Área 003;18943;18943;18935;8;0;4109401003003.0
Paraná;Área 004;18607;18607;18595;12;0;4109401003004.0
Paraná;Área 005;19421;19421;19421;0;0;4109401003005.0
Paraná;Área 006;14419;14419;14419;0;0;4109401003006.0
Paraná;Área 007;15297;15239;15140;99;58;4109401003007.0
Paraná;Área 008;22768;22742;22742;0;26;4109401003008.0
Paraná;Área 009;29046;29035;29012;23;11;4109401003009.0
Paraná;Guaratuba;32095;32000;32000;0;95;4109609.0
Paraná;Área 001;12312;12278;12278;0;34;4109609003001.0
Paraná;Área 002;19783;19722;19722;0;61;4109609003002.0
Paraná;Ibiporã;48198;48128;48077;51;70;4109807.0
Paraná;Área 001;21546;21544;21524;20;2;4109807003001.0
Paraná;Área 002;26652;26585;26553;32;67;4109807003002.0
Paraná;Imbituva;28455;28420;28420;0;35;4110102.0
Paraná;Área 001;14299;14264;14264;0;35;4110102003001.0
Paraná;Área 002;14156;14156;14156;0;0;4110102003002.0
Paraná;Irati;56207;56182;56159;22;25;4110706.0
Paraná;Área 001;13923;13916;13916;0;7;4110706003001.0
Paraná;Área 002;17040;17040;17040;0;0;4110706003002.0
Paraná;Área 003;25244;25226;25203;22;18;4110706003003.0
Paraná;Ivaiporã;31816;31757;31701;56;59;4111506.0
Paraná;Área 001;12185;12152;12106;46;33;4111506003001.0
Paraná;Área 002;19631;19605;19595;10;26;4111506003002.0
Paraná;Jacarezinho;39121;39095;39091;4;26;4111803.0
Paraná;Área 001;15317;15302;15298;4;15;4111803003001.0
Paraná;Área 002;23804;23793;23793;0;11;4111803003002.0
Paraná;Jaguariaíva;32606;32583;32529;54;23;4112009.0
Paraná;Área 001;16143;16131;16100;31;12;4112009003001.0
Paraná;Área 002;16463;16452;16429;23;11;4112009003002.0
Paraná;Lapa;44932;44904;44904;0;28;4113205.0
Paraná;Área 001;17511;17511;17511;0;0;4113205003001.0
Paraná;Área 002;27421;27393;27393;0;28;4113205003002.0
Paraná;Laranjeiras do Sul;30777;30765;30765;0;12;4113304.0
Paraná;Área 001;13629;13617;13617;0;12;4113304003001.0
Paraná;Área 002;17148;17148;17148;0;0;4113304003002.0
Paraná;Londrina;506701;505299;503887;1412;1402;4113700.0
Paraná;Centro;86114;85592;84853;739;522;4113700005001.0
Paraná;Distritos;21531;21477;21443;34;54;4113700005002.0
Paraná;Leste;95374;95288;95127;161;86;4113700005003.0
Paraná;Norte;130157;129939;129807;132;218;4113700005004.0
Paraná;Oeste;88847;88556;88386;170;291;4113700005005.0
Paraná;Sul;84678;84448;84272;176;230;4113700005006.0
Paraná;Mandaguari;32658;32612;32593;19;46;4114203.0
Paraná;Área 001;12685;12662;12662;0;23;4114203003001.0
Paraná;Área 002;19973;19950;19931;19;23;4114203003002.0
Paraná;Marechal Cândido Rondon;46819;46657;46393;264;162;4114609.0
Paraná;Área 001;17099;16979;16804;175;120;4114609003001.0
Paraná;Área 002;29720;29678;29589;90;42;4114609003002.0
Paraná;Marialva;31959;31848;31719;129;111;4114807.0
Paraná;Área 001;14015;13981;13945;36;34;4114807003001.0
Paraná;Área 002;17944;17867;17774;93;77;4114807003002.0
Paraná;Maringá;357077;355963;354815;1149;1114;4115200.0
Paraná;Área 001;13330;13310;13231;79;20;4115200004001.0
Paraná;Área 002;13548;13529;13485;44;19;4115200004002.0
Paraná;Área 003;19224;19210;19191;19;14;4115200004003.0
Paraná;Área 004;13906;13844;13815;30;62;4115200004004.0
Paraná;Área 005;13056;12990;12972;18;66;4115200004005.0
Paraná;Área 006;17076;17054;17021;34;22;4115200004006.0
Paraná;Área 007;19385;19290;19254;36;95;4115200004007.0
Paraná;Área 008;17509;17436;17415;21;73;4115200004008.0
Paraná;Área 009;15577;15459;15397;62;118;4115200004009.0
Paraná;Área 010;20636;20602;20528;73;34;4115200004010.0
Paraná;Área 011;20962;20915;20821;94;47;4115200004011.0
Paraná;Área 012;12916;12828;12711;117;88;4115200004012.0
Paraná;Área 013;18541;18433;18271;162;108;4115200004013.0
Paraná;Área 014;13720;13639;13548;90;81;4115200004014.0
Paraná;Área 015;15596;15495;15430;65;101;4115200004015.0
Paraná;Área 016;22131;22112;22092;19;19;4115200004016.0
Paraná;Área 017;21246;21194;21098;96;52;4115200004017.0
Paraná;Área 018;17293;17284;17276;8;9;4115200004018.0
Paraná;Área 019;24288;24260;24177;83;28;4115200004019.0
Paraná;Área 020;27137;27082;27082;0;55;4115200004020.0
Paraná;Matinhos;29428;29310;29264;46;118;4115705.0
Paraná;Área 001;13048;13000;12986;14;48;4115705003001.0
Paraná;Área 002;16380;16310;16278;32;70;4115705003002.0
Paraná;Medianeira;41817;41569;41376;193;248;4115804.0
Paraná;Área 001;18081;18015;17961;54;66;4115804003001.0
Paraná;Área 002;23736;23554;23416;138;182;4115804003002.0
Paraná;Paiçandu;35936;35911;35866;45;25;4117503.0
Paraná;Área 001;13153;13128;13083;45;25;4117503003001.0
Paraná;Área 002;22783;22783;22783;0;0;4117503003002.0
Paraná;Palmas;42888;42860;42810;50;28;4117602.0
Paraná;Área 001;17153;17153;17143;10;0;4117602003001.0
Paraná;Área 002;25735;25707;25667;40;28;4117602003002.0
Paraná;Palmeira;32123;32108;32086;22;15;4117701.0
Paraná;Área 001;12689;12684;12684;0;5;4117701003001.0
Paraná;Área 002;19434;19425;19402;22;9;4117701003002.0
Paraná;Palotina;28683;28643;28569;74;40;4117909.0
Paraná;Área 001;13113;13083;13044;39;30;4117909003001.0
Paraná;Área 002;15570;15560;15525;34;10;4117909003002.0
Paraná;Paranaguá;140469;140212;140057;155;257;4118204.0
Paraná;Área 001;14665;14665;14665;0;0;4118204003001.0
Paraná;Área 002;14523;14514;14506;8;9;4118204003002.0
Paraná;Área 003;24937;24894;24894;0;43;4118204003003.0
Paraná;Área 004;15886;15856;15805;51;30;4118204003004.0
Paraná;Área 005;24232;24150;24111;39;82;4118204003005.0
Paraná;Área 006;13412;13355;13310;45;57;4118204003006.0
Paraná;Área 007;32814;32777;32766;11;37;4118204003007.0
Paraná;Paranavaí;81590;81421;81226;195;169;4118402.0
Paraná;Área 001;12339;12321;12311;10;18;4118402003001.0
Paraná;Área 002;13708;13679;13572;106;29;4118402003002.0
Paraná;Área 003;12681;12603;12592;11;78;4118402003003.0
Paraná;Área 004;15724;15716;15686;31;8;4118402003004.0
Paraná;Área 005;27138;27102;27065;37;36;4118402003005.0
Paraná;Pato Branco;72370;72293;72227;66;77;4118501.0
Paraná;Área 001;13263;13263;13263;0;0;4118501003001.0
Paraná;Área 002;13025;13002;13002;0;23;4118501003002.0
Paraná;Área 003;22790;22769;22746;23;21;4118501003003.0
Paraná;Área 004;23292;23259;23216;43;33;4118501003004.0
Paraná;Pinhais;117008;116814;116715;99;194;4119152.0
Paraná;Área 001;13515;13505;13498;7;10;4119152003001.0
Paraná;Área 002;15219;15219;15185;34;0;4119152003002.0
Paraná;Área 003;29911;29849;29830;19;62;4119152003003.0
Paraná;Área 004;28644;28557;28527;30;87;4119152003004.0
Paraná;Área 005;29719;29684;29676;9;35;4119152003005.0
Paraná;Piraquara;93207;93122;93030;92;85;4119509.0
Paraná;Área 001;14384;14384;14384;0;0;4119509003001.0
Paraná;Área 002;15908;15897;15873;24;11;4119509003002.0
Paraná;Área 003;28181;28161;28129;32;20;4119509003003.0
Paraná;Área 004;34734;34680;34644;36;54;4119509003004.0
Paraná;Pitanga;32638;32638;32631;7;0;4119608.0
Paraná;Área 001;15390;15390;15383;7;0;4119608003001.0
Paraná;Área 002;17248;17248;17248;0;0;4119608003002.0
Paraná;Ponta Grossa;311611;311140;310851;289;471;4119905.0
Paraná;Área 001;20198;20183;20183;0;15;4119905004001.0
Paraná;Área 002;18091;18040;18020;19;51;4119905004002.0
Paraná;Área 003;14272;14242;14211;31;30;4119905004003.0
Paraná;Área 004;17496;17453;17429;24;43;4119905004004.0
Paraná;Área 005;19779;19769;19758;11;10;4119905004005.0
Paraná;Área 006;21517;21453;21445;9;64;4119905004006.0
Paraná;Área 007;13113;13113;13055;58;0;4119905004007.0
Paraná;Área 008;24883;24843;24843;0;40;4119905004008.0
Paraná;Área 009;25511;25471;25431;40;40;4119905004009.0
Paraná;Área 010;27739;27723;27723;0;16;4119905004010.0
Paraná;Área 011;23094;23094;23094;0;0;4119905004011.0
Paraná;Área 012;21495;21495;21482;13;0;4119905004012.0
Paraná;Área 013;16019;16000;16000;0;19;4119905004013.0
Paraná;Área 014;24105;24035;23994;41;70;4119905004014.0
Paraná;Área 015;24299;24225;24182;43;74;4119905004015.0
Paraná;Prudentópolis;48792;48792;48792;0;0;4120606.0
Paraná;Área 001;22067;22067;22067;0;0;4120606003001.0
Paraná;Área 002;26725;26725;26725;0;0;4120606003002.0
Paraná;Quedas do Iguaçu;30605;30582;30439;143;23;4120903.0
Paraná;Área 001;13568;13556;13516;40;12;4120903003001.0
Paraná;Área 002;17037;17025;16922;103;12;4120903003002.0
Paraná;Rio Branco do Sul;30650;30650;30650;0;0;4122206.0
Paraná;Área 001;13805;13805;13805;0;0;4122206003001.0
Paraná;Área 002;16845;16845;16845;0;0;4122206003002.0
Paraná;Rio Negro;31274;31274;31267;7;0;4122305.0
Paraná;Área 001;15571;15571;15564;7;0;4122305003001.0
Paraná;Área 002;15703;15703;15703;0;0;4122305003002.0
Paraná;Rolândia;57862;57663;57567;96;199;4122404.0
Paraná;Área 001;13100;13063;12998;66;37;4122404003001.0
Paraná;Área 002;20611;20593;20573;20;18;4122404003002.0
Paraná;Área 003;24151;24006;23996;10;145;4122404003003.0
Paraná;Santo Antônio da Platina;42707;42688;42660;28;19;4124103.0
Paraná;Área 001;21849;21841;21822;20;8;4124103003001.0
Paraná;Área 002;20858;20847;20838;9;11;4124103003002.0
Paraná;São José dos Pinhais;264210;263589;263321;268;621;4125506.0
Paraná;Regional 1-Centro-Sjp;107638;107357;107265;92;281;4125506005001.0
Paraná;Regional 2-Oeste-Sjp;59567;59365;59336;29;202;4125506005002.0
Paraná;Regional 3-Norte-Sjp;34542;34508;34447;61;34;4125506005003.0
Paraná;Regional 4-Leste-Sjp;26986;26943;26907;36;43;4125506005004.0
Paraná;Regional 5-Sul-Sjp;18469;18433;18406;26;36;4125506005005.0
Paraná;Regional 6-Rural-Sjp;17008;16983;16960;23;25;4125506005006.0
Paraná;São Mateus do Sul;41257;41257;41257;0;0;4125605.0
Paraná;Área 001;18167;18167;18167;0;0;4125605003001.0
Paraná;Área 002;23090;23090;23090;0;0;4125605003002.0
Paraná;Sarandi;82847;82809;82778;31;38;4126256.0
Paraná;Área 001;13977;13977;13968;9;0;4126256003001.0
Paraná;Área 002;14999;14999;14999;0;0;4126256003002.0
Paraná;Área 003;13623;13613;13613;0;10;4126256003003.0
Paraná;Área 004;14414;14414;14414;0;0;4126256003004.0
Paraná;Área 005;25834;25806;25784;22;28;4126256003005.0
Paraná;Telêmaco Borba;69872;69827;69796;31;45;4127106.0
Paraná;Área 001;15054;15054;15054;0;0;4127106003001.0
Paraná;Área 002;20339;20328;20317;11;11;4127106003002.0
Paraná;Área 003;34479;34445;34424;21;34;4127106003003.0
Paraná;Toledo;119313;119050;118674;377;263;4127700.0
Paraná;Área 001;13317;13281;13225;56;36;4127700003001.0
Paraná;Área 002;16744;16732;16696;36;12;4127700003002.0
Paraná;Área 003;13813;13743;13668;75;70;4127700003003.0
Paraná;Área 004;13535;13525;13473;52;10;4127700003004.0
Paraná;Área 005;13603;13524;13503;21;79;4127700003005.0
Paraná;Área 006;22036;22029;21990;40;7;4127700003006.0
Paraná;Área 007;26265;26217;26119;98;48;4127700003007.0
Paraná;Umuarama;100676;100439;100263;176;237;4128104.0
Paraná;Área 001;14663;14663;14637;26;0;4128104003001.0
Paraná;Área 002;23089;22999;22989;10;90;4128104003002.0
Paraná;Área 003;12247;12206;12176;31;41;4128104003003.0
Paraná;Área 004;23858;23786;23708;78;72;4128104003004.0
Paraná;Área 005;26819;26784;26754;31;35;4128104003005.0
Paraná;União da Vitória;52735;52692;52674;18;43;4128203.0
Paraná;Área 001;26025;26015;26015;0;10;4128203003001.0
Paraná;Área 002;26710;26677;26659;18;33;4128203003002.0
Santa Catarina;Araranguá;61310;61236;61203;33;74;4201406.0
Santa Catarina;Área 001;13178;13178;13168;10;0;4201406003001.0
Santa Catarina;Área 002;20723;20684;20674;11;39;4201406003002.0
Santa Catarina;Área 003;27409;27373;27361;12;36;4201406003003.0
Santa Catarina;Balneário Camboriú;108089;107010;106710;300;1079;4202008.0
Santa Catarina;Área 001;14349;14291;14283;8;58;4202008003001.0
Santa Catarina;Área 002;10813;10661;10592;69;152;4202008003002.0
Santa Catarina;Área 003;15763;15553;15503;50;210;4202008003003.0
Santa Catarina;Área 004;14778;14607;14572;34;171;4202008003004.0
Santa Catarina;Área 005;19470;19406;19397;9;64;4202008003005.0
Santa Catarina;Área 006;12480;12209;12165;44;271;4202008003006.0
Santa Catarina;Área 007;20436;20283;20198;85;153;4202008003007.0
Santa Catarina;Biguaçu;58206;58138;58110;28;68;4202305.0
Santa Catarina;Área 001;13544;13509;13509;0;35;4202305003001.0
Santa Catarina;Área 002;15482;15472;15472;0;10;4202305003002.0
Santa Catarina;Área 003;29180;29157;29129;28;23;4202305003003.0
Santa Catarina;Blumenau;309011;308284;307842;442;727;4202404.0
Santa Catarina;Asilo;20786;20631;20590;40;155;4202404005009.0
Santa Catarina;Caminhos do Sul-Leste;15967;15942;15942;0;25;4202404005001.0
Santa Catarina;Centro-Norte 1;14097;14097;14097;0;0;4202404005017.0
Santa Catarina;Centro-Norte 2;14142;14065;14065;0;77;4202404005018.0
Santa Catarina;Colonia;15826;15752;15700;52;74;4202404005005.0
Santa Catarina;Dois Ribeiroes;15648;15648;15619;29;0;4202404005014.0
Santa Catarina;Garcia;15911;15871;15799;72;40;4202404005002.0
Santa Catarina;Grande Velha;15373;15294;15294;0;79;4202404005007.0
Santa Catarina;Itoupava Norte;15134;15134;15134;0;0;4202404005013.0
Santa Catarina;Morro da Laguna;13321;13311;13279;31;10;4202404005012.0
Santa Catarina;Progresso 1;14934;14862;14851;12;72;4202404005003.0
Santa Catarina;Progresso 2;12803;12803;12803;0;0;4202404005004.0
Santa Catarina;Ribeirao Branco;23156;23110;23056;54;46;4202404005008.0
Santa Catarina;Saxonia;12564;12564;12556;8;0;4202404005011.0
Santa Catarina;Universidade;21786;21716;21677;39;70;4202404005010.0
Santa Catarina;Vale das Itoupavas 1;16212;16199;16164;35;13;4202404005015.0
Santa Catarina;Vale das Itoupavas 2;20317;20269;20225;45;48;4202404005016.0
Santa Catarina;Vale do Testo;15774;15764;15750;14;10;4202404005019.0
Santa Catarina;Velha;15260;15254;15242;12;6;4202404005006.0
Santa Catarina;Braço do Norte;29018;29010;28960;50;8;4202800.0
Santa Catarina;Área 001;14461;14453;14453;0;8;4202800003001.0
Santa Catarina;Área 002;14557;14557;14507;50;0;4202800003002.0
Santa Catarina;Brusque;105503;105437;105393;45;66;4202909.0
Santa Catarina;Área 001;14345;14336;14310;26;9;4202909003001.0
Santa Catarina;Área 002;16048;16048;16048;0;0;4202909003002.0
Santa Catarina;Área 003;20250;20238;20229;9;12;4202909003003.0
Santa Catarina;Área 004;25096;25071;25060;10;25;4202909003004.0
Santa Catarina;Área 005;29764;29745;29745;0;19;4202909003005.0
Santa Catarina;Caçador;70762;70729;70697;31;33;4203006.0
Santa Catarina;Área 001;15529;15529;15529;0;0;4203006003001.0
Santa Catarina;Área 002;27902;27880;27880;0;22;4203006003002.0
Santa Catarina;Área 003;27331;27320;27289;31;11;4203006003003.0
Santa Catarina;Camboriú;62361;62187;62126;62;174;4203204.0
Santa Catarina;Área 001;14387;14387;14387;0;0;4203204003001.0
Santa Catarina;Área 002;21375;21229;21177;52;146;4203204003002.0
Santa Catarina;Área 003;26599;26571;26562;9;28;4203204003003.0
Santa Catarina;Campos Novos;32824;32816;32809;7;8;4203600.0
Santa Catarina;Área 001;13889;13889;13882;7;0;4203600003001.0
Santa Catarina;Área 002;18935;18927;18927;0;8;4203600003002.0
Santa Catarina;Canoinhas;52765;52754;52742;13;11;4203808.0
Santa Catarina;Área 001;24603;24603;24603;0;0;4203808003001.0
Santa Catarina;Área 002;28162;28151;28139;13;11;4203808003002.0
Santa Catarina;Chapecó;183530;183447;183346;101;83;4204202.0
Santa Catarina;Área 001;12765;12765;12745;20;0;4204202003001.0
Santa Catarina;Área 002;13436;13436;13425;11;0;4204202003002.0
Santa Catarina;Área 003;15474;15463;15463;0;11;4204202003003.0
Santa Catarina;Área 004;16573;16573;16550;23;0;4204202003004.0
Santa Catarina;Área 005;16728;16715;16696;19;13;4204202003005.0
Santa Catarina;Área 006;10521;10483;10483;0;38;4204202003006.0
Santa Catarina;Área 007;21376;21366;21353;13;10;4204202003007.0
Santa Catarina;Área 008;18265;18253;18244;9;12;4204202003008.0
Santa Catarina;Área 009;12518;12518;12512;6;0;4204202003009.0
Santa Catarina;Área 010;21238;21238;21238;0;0;4204202003010.0
Santa Catarina;Área 011;24636;24636;24636;0;0;4204202003011.0
Santa Catarina;Concórdia;68621;68621;68611;10;0;4204301.0
Santa Catarina;Área 001;11872;11872;11862;10;0;4204301003001.0
Santa Catarina;Área 002;14101;14101;14101;0;0;4204301003002.0
Santa Catarina;Área 003;19077;19077;19077;0;0;4204301003003.0
Santa Catarina;Área 004;23571;23571;23571;0;0;4204301003004.0
Santa Catarina;Criciúma;192308;191981;191824;157;327;4204608.0
Santa Catarina;Distrito de Rio Maina Zona Norte;20209;20184;20184;0;25;4204608005001.0
Santa Catarina;Distrito de Rio Maina Zona Sul 1;15201;15201;15192;9;0;4204608005002.0
Santa Catarina;Distrito de Rio Maina Zona Sul 2;18659;18638;18629;9;21;4204608005003.0
Santa Catarina;Grande Pinheirinho;25122;25111;25104;7;11;4204608005004.0
Santa Catarina;Grande Prospera;18150;18150;18138;12;0;4204608005005.0
Santa Catarina;Grande São Luiz;16357;16357;16347;10;0;4204608005006.0
Santa Catarina;Região Central 1;12738;12702;12702;0;36;4204608005007.0
Santa Catarina;Região Central 2;13928;13895;13875;20;33;4204608005008.0
Santa Catarina;Região Central 3;14164;14033;13961;72;131;4204608005009.0
Santa Catarina;Região Norte;21342;21289;21289;0;53;4204608005010.0
Santa Catarina;Região Sul;16438;16421;16403;18;17;4204608005011.0
Santa Catarina;Curitibanos;37748;37716;37684;32;32;4204806.0
Santa Catarina;Área 001;13209;13209;13209;0;0;4204806003001.0
Santa Catarina;Área 002;24539;24507;24475;32;32;4204806003002.0
Santa Catarina;Florianópolis;421240;417674;416618;1057;3566;4205407.0
Santa Catarina;Abraão-Itaguaçú- Bom Abrigo;11939;11906;11858;48;33;4205407005024.0
Santa Catarina;Agronômica e Trindade Norte;16075;15838;15789;48;237;4205407005018.0
Santa Catarina;Altos da Felipe Schmidt;11250;11099;11054;45;151;4205407005023.0
Santa Catarina;Canto e Coloninha;12466;12428;12428;0;38;4205407005029.0
Santa Catarina;Capoeiras;14211;14193;14162;32;18;4205407005026.0
Santa Catarina;Centro;12657;12544;12460;84;113;4205407005022.0
Santa Catarina;Coqueiros;13263;13196;13172;24;67;4205407005025.0
Santa Catarina;Corrego Grande e Santa Monica;12221;12123;11979;144;98;4205407005015.0
Santa Catarina;Costeira do Pirajubae;14837;14805;14777;28;32;4205407005016.0
Santa Catarina;Distrito Cachoeira do Bom Jesus;13501;13372;13324;48;129;4205407005002.0
Santa Catarina;Distrito Campeche 1;11926;11847;11813;33;79;4205407005008.0
Santa Catarina;Distrito Campeche 2;12097;11988;11955;33;109;4205407005009.0
Santa Catarina;Distrito Canasvieiras;18091;17699;17635;64;392;4205407005001.0
Santa Catarina;Distrito de São João do Rio Vermelho;13513;13273;13217;56;240;4205407005006.0
Santa Catarina;Distrito Ingleses do Rio Vermelho 1;13040;12890;12863;27;150;4205407005003.0
Santa Catarina;Distrito Ingleses do Rio Vermelho 2;16774;16484;16455;29;290;4205407005004.0
Santa Catarina;Distrito Ribeirao da Ilha 1;14279;14237;14229;8;42;4205407005010.0
Santa Catarina;Distrito Ribeirao da Ilha 2;12715;12655;12655;0;60;4205407005011.0
Santa Catarina;Distritos Lagoa da Conceicao e Barra da Lagoa;17485;17098;17051;47;387;4205407005007.0
Santa Catarina;Distritos Pantano do Sul e Parte do Campeche Sul;13402;13128;13097;31;274;4205407005012.0
Santa Catarina;Distritos Santo Antônio de Lisboa, Ratones e Parte da Cachoei;14940;14861;14815;45;79;4205407005005.0
Santa Catarina;Estreito e Balneario;11440;11387;11332;54;53;4205407005030.0
Santa Catarina;Itacorubi;15665;15561;15549;12;104;4205407005014.0
Santa Catarina;Jardim Atlantico;13159;13096;13091;5;63;4205407005028.0
Santa Catarina;Joao Paulo, Monte Verde e Saco Grande;18810;18755;18731;24;55;4205407005013.0
Santa Catarina;Macico Norte;13931;13909;13898;12;22;4205407005019.0
Santa Catarina;Macico Sul;13678;13624;13624;0;54;4205407005020.0
Santa Catarina;Mauro Ramos;11030;10976;10941;34;54;4205407005021.0
Santa Catarina;Monte Cristo;14696;14684;14684;0;12;4205407005027.0
Santa Catarina;Saco dos Limoes e Trindade Sul;18149;18019;17979;40;130;4205407005017.0
Santa Catarina;Fraiburgo;34553;34542;34524;17;11;4205506.0
Santa Catarina;Área 001;16272;16261;16243;17;11;4205506003001.0
Santa Catarina;Área 002;18281;18281;18281;0;0;4205506003002.0
Santa Catarina;Gaspar;57981;57981;57971;10;0;4205902.0
Santa Catarina;Área 001;13130;13130;13130;0;0;4205902003001.0
Santa Catarina;Área 002;19296;19296;19295;1;0;4205902003002.0
Santa Catarina;Área 003;25555;25555;25546;9;0;4205902003003.0
Santa Catarina;Guaramirim;35172;35119;35099;20;53;4206504.0
Santa Catarina;Área 001;13272;13262;13250;12;10;4206504003001.0
Santa Catarina;Área 002;21900;21858;21849;8;42;4206504003002.0
Santa Catarina;Içara;58833;58755;58654;100;78;4207007.0
Santa Catarina;Área 001;13726;13708;13680;28;18;4207007003001.0
Santa Catarina;Área 002;21219;21178;21157;21;41;4207007003002.0
Santa Catarina;Área 003;23888;23869;23818;51;19;4207007003003.0
Santa Catarina;Imbituba;40170;40046;40038;8;124;4207304.0
Santa Catarina;Área 001;18754;18719;18719;0;35;4207304003001.0
Santa Catarina;Área 002;21416;21327;21319;8;89;4207304003002.0
Santa Catarina;Indaial;54854;54787;54728;59;67;4207502.0
Santa Catarina;Área 001;13088;13088;13048;40;0;4207502003001.0
Santa Catarina;Área 002;20097;20061;20042;19;36;4207502003002.0
Santa Catarina;Área 003;21669;21639;21639;0;30;4207502003003.0
Santa Catarina;Itajaí;183373;182831;182649;182;542;4208203.0
Santa Catarina;Área 001;13163;13150;13150;0;13;4208203003001.0
Santa Catarina;Área 002;14031;14000;13990;10;31;4208203003002.0
Santa Catarina;Área 003;15215;15188;15181;7;27;4208203003003.0
Santa Catarina;Área 004;14492;14445;14431;14;47;4208203003004.0
Santa Catarina;Área 005;28751;28497;28421;76;254;4208203003005.0
Santa Catarina;Área 006;13492;13481;13476;5;11;4208203003006.0
Santa Catarina;Área 007;14109;14047;14029;18;62;4208203003007.0
Santa Catarina;Área 008;15172;15130;15111;19;42;4208203003008.0
Santa Catarina;Área 009;21322;21295;21295;0;27;4208203003009.0
Santa Catarina;Área 010;33626;33598;33565;34;28;4208203003010.0
Santa Catarina;Itapema;45797;45556;45513;43;241;4208302.0
Santa Catarina;Área 001;22435;22374;22351;23;61;4208302003001.0
Santa Catarina;Área 002;23362;23181;23161;20;181;4208302003002.0
Santa Catarina;Jaraguá do Sul;143123;143012;142843;169;111;4208906.0
Santa Catarina;Área 001;16634;16619;16610;9;15;4208906003001.0
Santa Catarina;Área 002;16689;16678;16660;19;11;4208906003002.0
Santa Catarina;Área 003;15836;15836;15814;22;0;4208906003003.0
Santa Catarina;Área 004;16029;16009;15997;12;20;4208906003004.0
Santa Catarina;Área 005;11344;11323;11323;0;21;4208906003005.0
Santa Catarina;Área 006;12264;12237;12197;40;27;4208906003006.0
Santa Catarina;Área 007;23686;23678;23645;32;8;4208906003007.0
Santa Catarina;Área 008;30641;30633;30597;36;8;4208906003008.0
Santa Catarina;Joaçaba;27020;26999;26973;27;21;4209003.0
Santa Catarina;Área 001;13029;13017;12990;27;12;4209003003001.0
Santa Catarina;Área 002;13991;13983;13983;0;8;4209003003002.0
Santa Catarina;Joinville;515288;514388;513922;467;900;4209102.0
Santa Catarina;Adhemar Garcia e Jarivatuba;21596;21587;21587;0;9;4209102005001.0
Santa Catarina;Aventureiro 1;18807;18807;18807;0;0;4209102005002.0
Santa Catarina;Aventureiro 2;16856;16856;16856;0;0;4209102005003.0
Santa Catarina;Boa Vista;16682;16616;16616;0;66;4209102005004.0
Santa Catarina;Boehmerwaldt;16224;16202;16197;5;22;4209102005005.0
Santa Catarina;Bom Retiro, Santo Antônio e Jardim Sofia;22783;22727;22691;36;56;4209102005006.0
Santa Catarina;Bucarem e Guanabara;16780;16780;16773;7;0;4209102005007.0
Santa Catarina;Centro e America;16225;15983;15898;85;242;4209102005008.0
Santa Catarina;Comasa;19601;19573;19557;16;28;4209102005009.0
Santa Catarina;Costa e Silva 1;14313;14299;14299;0;14;4209102005010.0
Santa Catarina;Costa e Silva 2;13112;13074;13061;13;38;4209102005011.0
Santa Catarina;Fatima;14031;14025;14025;0;6;4209102005012.0
Santa Catarina;Floresta;17986;17986;17974;12;0;4209102005013.0
Santa Catarina;Gloria, Atiradores e Anita Garibaldi 1;11361;11325;11307;18;36;4209102005014.0
Santa Catarina;Gloria, Atiradores e Anita Garibaldi 2;12124;12055;12021;34;69;4209102005015.0
Santa Catarina;Iririu;22344;22324;22303;21;20;4209102005016.0
Santa Catarina;Itaum;14287;14268;14268;0;19;4209102005017.0
Santa Catarina;Jardim Iririu;22756;22713;22699;14;43;4209102005018.0
Santa Catarina;Jardim Paraíso;16791;16779;16748;31;12;4209102005019.0
Santa Catarina;Joao Costa e Parque Guarani;23193;23173;23173;0;20;4209102005020.0
Santa Catarina;Leste Joinville Com Vila Cubatao, Espinheiros E;14611;14611;14611;0;0;4209102005029.0
Santa Catarina;Petrópolis;13368;13359;13339;20;9;4209102005021.0
Santa Catarina;Pirabeiraba e Rural Oeste;23191;23174;23119;55;17;4209102005022.0
Santa Catarina;Saguacu;13087;12942;12914;28;145;4209102005023.0
Santa Catarina;Santa Catarina, Profipo e Itinga;16838;16838;16838;0;0;4209102005024.0
Santa Catarina;São Marcos, Nova Brasilia e Morro do Meio;25772;25772;25754;18;0;4209102005025.0
Santa Catarina;Ulisses Guimaraes e Paranaguá Mirim 1;18349;18349;18330;19;0;4209102005026.0
Santa Catarina;Ulisses Guimaraes e Paranaguá Mirim 2;18269;18259;18259;0;10;4209102005027.0
Santa Catarina;Vila Nova;23951;23932;23899;33;19;4209102005028.0
Santa Catarina;Lages;156727;156645;156623;22;82;4209300.0
Santa Catarina;Área 001;14129;14120;14120;0;9;4209300003001.0
Santa Catarina;Área 002;17793;17793;17793;0;0;4209300003002.0
Santa Catarina;Área 003;14135;14135;14135;0;0;4209300003003.0
Santa Catarina;Área 004;18041;18041;18041;0;0;4209300003004.0
Santa Catarina;Área 005;11643;11616;11601;16;27;4209300003005.0
Santa Catarina;Área 006;20081;20067;20067;0;14;4209300003006.0
Santa Catarina;Área 007;14110;14110;14110;0;0;4209300003007.0
Santa Catarina;Área 008;21817;21817;21817;0;0;4209300003008.0
Santa Catarina;Área 009;24978;24945;24938;7;33;4209300003009.0
Santa Catarina;Laguna;51562;51522;51495;27;40;4209409.0
Santa Catarina;Área 001;12228;12228;12228;0;0;4209409003001.0
Santa Catarina;Área 002;16421;16400;16387;13;21;4209409003002.0
Santa Catarina;Área 003;22913;22894;22880;14;19;4209409003003.0
Santa Catarina;Mafra;52912;52892;52885;6;20;4210100.0
Santa Catarina;Área 001;25534;25534;25528;6;0;4210100003001.0
Santa Catarina;Área 002;27378;27358;27358;0;20;4210100003002.0
Santa Catarina;Navegantes;60556;60495;60423;72;61;4211306.0
Santa Catarina;Área 001;12488;12488;12479;9;0;4211306003001.0
Santa Catarina;Área 002;19218;19218;19182;36;0;4211306003002.0
Santa Catarina;Área 003;28850;28789;28762;27;61;4211306003003.0
Santa Catarina;Palhoça;137334;137244;137091;153;90;4211900.0
Santa Catarina;Área 001;13053;13042;13021;21;11;4211900003001.0
Santa Catarina;Área 002;13753;13699;13636;64;54;4211900003002.0
Santa Catarina;Área 003;14873;14873;14843;30;0;4211900003003.0
Santa Catarina;Área 004;14225;14225;14216;9;0;4211900003004.0
Santa Catarina;Área 005;13491;13491;13480;11;0;4211900003005.0
Santa Catarina;Área 006;26501;26501;26482;19;0;4211900003006.0
Santa Catarina;Área 007;41438;41412;41412;0;26;4211900003007.0
Santa Catarina;Pomerode;27759;27679;27649;29;80;4213203.0
Santa Catarina;Área 001;12994;12963;12963;0;31;4213203003001.0
Santa Catarina;Área 002;14765;14716;14687;29;49;4213203003002.0
Santa Catarina;Porto União;33493;33476;33476;0;17;4213609.0
Santa Catarina;Área 001;12518;12501;12501;0;17;4213609003001.0
Santa Catarina;Área 002;20975;20975;20975;0;0;4213609003002.0
Santa Catarina;Rio do Sul;61198;61106;61091;15;92;4214805.0
Santa Catarina;Área 001;15147;15138;15138;0;9;4214805003001.0
Santa Catarina;Área 002;22252;22220;22213;7;32;4214805003002.0
Santa Catarina;Área 003;23799;23748;23740;8;51;4214805003003.0
Santa Catarina;Rio Negrinho;39846;39826;39815;11;20;4215000.0
Santa Catarina;Área 001;15010;15010;14999;11;0;4215000003001.0
Santa Catarina;Área 002;24836;24816;24816;0;20;4215000003002.0
Santa Catarina;São Bento do Sul;74801;74667;74622;45;134;4215802.0
Santa Catarina;Área 001;13543;13509;13509;0;34;4215802003001.0
Santa Catarina;Área 002;14476;14476;14476;0;0;4215802003002.0
Santa Catarina;Área 003;22688;22654;22644;10;34;4215802003003.0
Santa Catarina;Área 004;24094;24028;23993;35;66;4215802003004.0
Santa Catarina;São Francisco do Sul;42520;42431;42415;16;89;4216206.0
Santa Catarina;Área 001;18273;18246;18230;16;27;4216206003001.0
Santa Catarina;Área 002;24247;24185;24185;0;62;4216206003002.0
Santa Catarina;São João Batista;26260;26233;26233;0;27;4216305.0
Santa Catarina;Área 001;13402;13402;13402;0;0;4216305003001.0
Santa Catarina;Área 002;12858;12831;12831;0;27;4216305003002.0
Santa Catarina;São José;209804;209494;209236;259;310;4216602.0
Santa Catarina;Área 001;12676;12620;12586;34;56;4216602005001.0
Santa Catarina;Área 002;13936;13898;13852;46;38;4216602005002.0
Santa Catarina;Área 003;16524;16440;16418;21;84;4216602005003.0
Santa Catarina;Área 004;14306;14306;14297;9;0;4216602005004.0
Santa Catarina;Área 005;12849;12836;12836;0;13;4216602005005.0
Santa Catarina;Área 006;12897;12885;12885;0;12;4216602005006.0
Santa Catarina;Área 007;15808;15801;15801;0;7;4216602005007.0
Santa Catarina;Área 008;15149;15129;15090;39;20;4216602005008.0
Santa Catarina;Área 009;12856;12855;12840;15;1;4216602005009.0
Santa Catarina;Área 010;12721;12689;12678;11;32;4216602005010.0
Santa Catarina;Área 011;13272;13261;13220;41;11;4216602005011.0
Santa Catarina;Área 012;13069;13069;13069;0;0;4216602005012.0
Santa Catarina;Área 013;16796;16784;16776;9;12;4216602005013.0
Santa Catarina;Área 014;13803;13803;13794;9;0;4216602005014.0
Santa Catarina;Área 015;13142;13118;13094;25;24;4216602005015.0
Santa Catarina;São Miguel do Oeste;36306;36261;36211;50;45;4217204.0
Santa Catarina;Área 001;13124;13079;13050;29;45;4217204003001.0
Santa Catarina;Área 002;23182;23182;23161;21;0;4217204003002.0
Santa Catarina;Sombrio;26613;26579;26538;41;34;4217709.0
Santa Catarina;Área 001;11827;11793;11752;41;34;4217709003001.0
Santa Catarina;Área 002;14786;14786;14786;0;0;4217709003002.0
Santa Catarina;Tijucas;30960;30902;30902;0;58;4218004.0
Santa Catarina;Área 001;14358;14345;14345;0;13;4218004003001.0
Santa Catarina;Área 002;16602;16557;16557;0;45;4218004003002.0
Santa Catarina;Timbó;36774;36715;36684;31;59;4218202.0
Santa Catarina;Área 001;14595;14595;14583;12;0;4218202003001.0
Santa Catarina;Área 002;22179;22120;22101;19;59;4218202003002.0
Santa Catarina;Três Barras;18129;18129;18125;4;0;4218301.0
Santa Catarina;Distrito 05 de Três Barras;9812;9812;9812;0;0;4218301002001.0
Santa Catarina;Distrito 10 de Três Barras;8317;8317;8313;4;0;4218301002002.0
Santa Catarina;Tubarão;97235;97149;97096;53;86;4218707.0
Santa Catarina;Área 001;11049;11037;11011;25;12;4218707003001.0
Santa Catarina;Área 002;12616;12616;12613;3;0;4218707003002.0
Santa Catarina;Área 003;21563;21551;21551;0;12;4218707003003.0
Santa Catarina;Área 004;13943;13943;13932;11;0;4218707003004.0
Santa Catarina;Área 005;13933;13924;13924;0;9;4218707003005.0
Santa Catarina;Área 006;24131;24077;24064;13;54;4218707003006.0
Santa Catarina;Videira;47188;47100;47067;33;88;4219309.0
Santa Catarina;Área 001;22825;22767;22767;0;58;4219309003001.0
Santa Catarina;Área 002;24363;24334;24300;33;29;4219309003002.0
Santa Catarina;Xanxerê;44128;44117;44104;13;11;4219507.0
Santa Catarina;Área 001;20305;20305;20305;0;0;4219507003001.0
Santa Catarina;Área 002;23823;23812;23799;13;11;4219507003002.0
Rio Grande do Sul;Alegrete;77653;77589;77581;8;64;4300406.0
Rio Grande do Sul;Área 001;12235;12219;12211;8;16;4300406003001.0
Rio Grande do Sul;Área 002;13176;13176;13176;0;0;4300406003002.0
Rio Grande do Sul;Área 003;24042;24024;24024;0;18;4300406003003.0
Rio Grande do Sul;Área 004;28200;28170;28170;0;30;4300406003004.0
Rio Grande do Sul;Alvorada;195673;195483;195447;35;190;4300604.0
Rio Grande do Sul;Algarve;27562;27545;27532;12;17;4300604005004.0
Rio Grande do Sul;Americana;25640;25608;25608;0;32;4300604005001.0
Rio Grande do Sul;Aparecida;15872;15872;15872;0;0;4300604005005.0
Rio Grande do Sul;Centro;17798;17754;17742;11;44;4300604005002.0
Rio Grande do Sul;Formosa;22232;22211;22211;0;21;4300604005007.0
Rio Grande do Sul;Intersul;20338;20326;20326;0;12;4300604005003.0
Rio Grande do Sul;Maria Regina;18633;18609;18597;12;24;4300604005006.0
Rio Grande do Sul;Piratini;18037;18008;18008;0;29;4300604005009.0
Rio Grande do Sul;Umbu-Industrial;29561;29551;29551;0;10;4300604005008.0
Rio Grande do Sul;Bagé;116794;116624;116463;162;170;4301602.0
Rio Grande do Sul;Área 001;13499;13464;13453;11;35;4301602003001.0
Rio Grande do Sul;Área 002;31698;31665;31602;64;33;4301602003002.0
Rio Grande do Sul;Área 003;16582;16535;16511;24;47;4301602003003.0
Rio Grande do Sul;Área 004;23498;23475;23444;31;23;4301602003004.0
Rio Grande do Sul;Área 005;31517;31485;31452;33;32;4301602003005.0
Rio Grande do Sul;Bento Gonçalves;107278;107150;107092;58;128;4302105.0
Rio Grande do Sul;Área 001;13814;13814;13804;10;0;4302105003001.0
Rio Grande do Sul;Área 002;12345;12345;12324;21;0;4302105003002.0
Rio Grande do Sul;Área 003;14341;14341;14341;0;0;4302105003003.0
Rio Grande do Sul;Área 004;12785;12785;12778;7;0;4302105003004.0
Rio Grande do Sul;Área 005;13757;13718;13718;0;39;4302105003005.0
Rio Grande do Sul;Área 006;20914;20866;20866;0;48;4302105003006.0
Rio Grande do Sul;Área 007;19322;19281;19261;20;41;4302105003007.0
Rio Grande do Sul;Caçapava do Sul;33690;33674;33674;0;16;4302808.0
Rio Grande do Sul;Área 001;14048;14032;14032;0;16;4302808003001.0
Rio Grande do Sul;Área 002;19642;19642;19642;0;0;4302808003002.0
Rio Grande do Sul;Cachoeira do Sul;83827;83807;83786;21;20;4303004.0
Rio Grande do Sul;Área 001;10829;10809;10788;21;20;4303004003001.0
Rio Grande do Sul;Área 002;13572;13572;13572;0;0;4303004003002.0
Rio Grande do Sul;Área 003;18143;18143;18143;0;0;4303004003003.0
Rio Grande do Sul;Área 004;20142;20142;20142;0;0;4303004003004.0
Rio Grande do Sul;Área 005;21141;21141;21141;0;0;4303004003005.0
Rio Grande do Sul;Cachoeirinha;118278;118170;118065;106;108;4303103.0
Rio Grande do Sul;Área 001;12653;12638;12638;0;15;4303103003001.0
Rio Grande do Sul;Área 002;12339;12330;12330;0;9;4303103003002.0
Rio Grande do Sul;Área 003;26275;26275;26258;17;0;4303103003003.0
Rio Grande do Sul;Área 004;13315;13278;13256;22;37;4303103003004.0
Rio Grande do Sul;Área 005;17644;17626;17598;28;18;4303103003005.0
Rio Grande do Sul;Área 006;36052;36022;35984;39;30;4303103003006.0
Rio Grande do Sul;Camaquã;62764;62764;62744;20;0;4303509.0
Rio Grande do Sul;Área 001;22251;22251;22240;11;0;4303509003001.0
Rio Grande do Sul;Área 002;18612;18612;18612;0;0;4303509003002.0
Rio Grande do Sul;Área 003;21901;21901;21892;9;0;4303509003003.0
Rio Grande do Sul;Campo Bom;60074;60046;59996;51;28;4303905.0
Rio Grande do Sul;Área 001;12803;12803;12784;19;0;4303905003001.0
Rio Grande do Sul;Área 002;22903;22883;22874;9;20;4303905003002.0
Rio Grande do Sul;Área 003;24368;24360;24337;23;8;4303905003003.0
Rio Grande do Sul;Candelária;30171;30171;30171;0;0;4304200.0
Rio Grande do Sul;Área 001;16320;16320;16320;0;0;4304200003001.0
Rio Grande do Sul;Área 002;13851;13851;13851;0;0;4304200003002.0
Rio Grande do Sul;Canela;39229;39155;39113;42;74;4304408.0
Rio Grande do Sul;Área 001;17449;17437;17414;23;12;4304408003001.0
Rio Grande do Sul;Área 002;21780;21718;21699;19;62;4304408003002.0
Rio Grande do Sul;Canguçu;53259;53248;53238;11;11;4304507.0
Rio Grande do Sul;Área 001;13386;13386;13386;0;0;4304507003001.0
Rio Grande do Sul;Área 002;20179;20179;20179;0;0;4304507003002.0
Rio Grande do Sul;Área 003;19694;19683;19673;11;11;4304507003003.0
Rio Grande do Sul;Canoas;323827;323280;322963;317;547;4304606.0
Rio Grande do Sul;Área 001;20951;20907;20899;8;44;4304606005001.0
Rio Grande do Sul;Área 002;22715;22687;22672;15;28;4304606005002.0
Rio Grande do Sul;Área 003;16811;16811;16798;13;0;4304606005003.0
Rio Grande do Sul;Área 004;11792;11760;11737;23;32;4304606005004.0
Rio Grande do Sul;Área 005;21203;21179;21169;10;24;4304606005005.0
Rio Grande do Sul;Área 006;15525;15492;15481;12;33;4304606005006.0
Rio Grande do Sul;Área 007;16453;16406;16406;0;47;4304606005007.0
Rio Grande do Sul;Área 008;23443;23375;23313;62;68;4304606005008.0
Rio Grande do Sul;Área 009;15305;15292;15267;25;13;4304606005009.0
Rio Grande do Sul;Área 010;14228;14176;14176;0;52;4304606005010.0
Rio Grande do Sul;Área 011;14156;14140;14140;0;16;4304606005011.0
Rio Grande do Sul;Área 012;12662;12626;12615;10;36;4304606005012.0
Rio Grande do Sul;Área 013;12771;12771;12762;9;0;4304606005013.0
Rio Grande do Sul;Área 014;13722;13624;13553;70;98;4304606005014.0
Rio Grande do Sul;Área 015;19782;19771;19762;9;11;4304606005015.0
Rio Grande do Sul;Área 016;14254;14254;14232;22;0;4304606005016.0
Rio Grande do Sul;Área 017;20248;20248;20236;12;0;4304606005017.0
Rio Grande do Sul;Área 018;16946;16934;16926;8;12;4304606005018.0
Rio Grande do Sul;Área 019;20860;20827;20817;9;33;4304606005019.0
Rio Grande do Sul;Capão da Canoa;42040;41981;41957;25;59;4304630.0
Rio Grande do Sul;Área 001;21060;21013;20988;25;47;4304630003001.0
Rio Grande do Sul;Área 002;20980;20969;20969;0;11;4304630003002.0
Rio Grande do Sul;Carazinho;59317;59249;59220;29;68;4304705.0
Rio Grande do Sul;Área 001;12921;12909;12909;0;12;4304705003001.0
Rio Grande do Sul;Área 002;21592;21567;21538;29;25;4304705003002.0
Rio Grande do Sul;Área 003;24804;24774;24774;0;30;4304705003003.0
Rio Grande do Sul;Carlos Barbosa;25192;25165;25165;0;27;4304804.0
Rio Grande do Sul;Área 001;12092;12074;12074;0;18;4304804003001.0
Rio Grande do Sul;Área 002;13100;13090;13090;0;10;4304804003002.0
Rio Grande do Sul;Caxias do Sul;435564;434832;434606;226;732;4305108.0
Rio Grande do Sul;Área 001;12190;12175;12175;0;15;4305108004001.0
Rio Grande do Sul;Área 002;12963;12963;12963;0;0;4305108004002.0
Rio Grande do Sul;Área 003;13867;13867;13856;11;0;4305108004003.0
Rio Grande do Sul;Área 004;10991;10960;10947;13;31;4305108004004.0
Rio Grande do Sul;Área 005;12466;12435;12435;0;31;4305108004005.0
Rio Grande do Sul;Área 006;10760;10760;10760;0;0;4305108004006.0
Rio Grande do Sul;Área 007;12649;12649;12649;0;0;4305108004007.0
Rio Grande do Sul;Área 008;17572;17572;17560;12;0;4305108004008.0
Rio Grande do Sul;Área 009;13374;13364;13364;0;10;4305108004009.0
Rio Grande do Sul;Área 010;14073;14073;14063;10;0;4305108004010.0
Rio Grande do Sul;Área 011;12475;12433;12413;21;42;4305108004011.0
Rio Grande do Sul;Área 012;42075;42075;42044;31;0;4305108004012.0
Rio Grande do Sul;Área 013;16075;16047;16047;0;28;4305108004013.0
Rio Grande do Sul;Área 014;11839;11826;11826;0;13;4305108004014.0
Rio Grande do Sul;Área 015;13858;13829;13829;0;29;4305108004015.0
Rio Grande do Sul;Área 016;20109;20034;20024;11;75;4305108004016.0
Rio Grande do Sul;Área 017;11231;11160;11150;10;71;4305108004017.0
Rio Grande do Sul;Área 018;18993;18983;18983;0;10;4305108004018.0
Rio Grande do Sul;Área 019;17109;17065;17045;20;44;4305108004019.0
Rio Grande do Sul;Área 020;19978;19963;19952;11;15;4305108004020.0
Rio Grande do Sul;Área 021;16153;16127;16102;25;26;4305108004021.0
Rio Grande do Sul;Área 022;15978;15931;15931;0;47;4305108004022.0
Rio Grande do Sul;Área 023;22950;22907;22907;0;43;4305108004023.0
Rio Grande do Sul;Área 024;14750;14697;14697;0;53;4305108004024.0
Rio Grande do Sul;Área 025;16224;16162;16150;13;62;4305108004025.0
Rio Grande do Sul;Área 026;12030;11984;11962;22;46;4305108004026.0
Rio Grande do Sul;Área 027;22832;22790;22772;18;42;4305108004027.0
Rio Grande do Sul;Charqueadas;35320;35308;35289;19;12;4305355.0
Rio Grande do Sul;Área 001;13764;13764;13764;0;0;4305355003001.0
Rio Grande do Sul;Área 002;21556;21544;21525;19;12;4305355003002.0
Rio Grande do Sul;Cruz Alta;62821;62776;62729;47;45;4306106.0
Rio Grande do Sul;Área 001;13506;13506;13487;19;0;4306106003001.0
Rio Grande do Sul;Área 002;22455;22435;22435;0;20;4306106003002.0
Rio Grande do Sul;Área 003;26860;26835;26807;28;25;4306106003003.0
Rio Grande do Sul;Dois Irmãos;27572;27532;27487;45;40;4306403.0
Rio Grande do Sul;Área 001;11333;11315;11287;28;18;4306403003001.0
Rio Grande do Sul;Área 002;16239;16217;16200;17;22;4306403003002.0
Rio Grande do Sul;Dom Pedrito;38898;38707;38660;47;191;4306601.0
Rio Grande do Sul;Área 001;16149;16096;16087;9;53;4306601003001.0
Rio Grande do Sul;Área 002;22749;22612;22573;38;137;4306601003002.0
Rio Grande do Sul;Eldorado do Sul;34343;34277;34266;10;66;4306767.0
Rio Grande do Sul;Área 001;13220;13195;13184;10;25;4306767003001.0
Rio Grande do Sul;Área 002;21123;21082;21082;0;41;4306767003002.0
Rio Grande do Sul;Erechim;96087;96064;96037;27;23;4307005.0
Rio Grande do Sul;Área 001;13823;13823;13823;0;0;4307005003001.0
Rio Grande do Sul;Área 002;15098;15098;15098;0;0;4307005003002.0
Rio Grande do Sul;Área 003;13007;13007;13007;0;0;4307005003003.0
Rio Grande do Sul;Área 004;12490;12490;12477;13;0;4307005003004.0
Rio Grande do Sul;Área 005;18740;18717;18703;14;23;4307005003005.0
Rio Grande do Sul;Área 006;22929;22929;22929;0;0;4307005003006.0
Rio Grande do Sul;Estância Velha;42574;42443;42422;21;131;4307609.0
Rio Grande do Sul;Área 001;20474;20395;20384;11;79;4307609003001.0
Rio Grande do Sul;Área 002;22100;22048;22038;11;52;4307609003002.0
Rio Grande do Sul;Esteio;80755;80587;80563;24;168;4307708.0
Rio Grande do Sul;Área 001;14302;14275;14275;0;27;4307708003001.0
Rio Grande do Sul;Área 002;14281;14268;14257;11;13;4307708003002.0
Rio Grande do Sul;Área 003;13206;13172;13158;13;34;4307708003003.0
Rio Grande do Sul;Área 004;20037;19987;19987;0;50;4307708003004.0
Rio Grande do Sul;Área 005;18929;18886;18886;0;43;4307708003005.0
Rio Grande do Sul;Estrela;30619;30574;30546;29;45;4307807.0
Rio Grande do Sul;Área 001;13875;13862;13853;9;13;4307807003001.0
Rio Grande do Sul;Área 002;16744;16712;16693;20;32;4307807003002.0
Rio Grande do Sul;Farroupilha;63635;63569;63524;45;66;4307906.0
Rio Grande do Sul;Área 001;13338;13328;13310;17;10;4307906003001.0
Rio Grande do Sul;Área 002;20949;20893;20865;28;56;4307906003002.0
Rio Grande do Sul;Área 003;29348;29348;29348;0;0;4307906003003.0
Rio Grande do Sul;Flores da Cunha;27126;27084;27049;34;42;4308201.0
Rio Grande do Sul;Área 001;13157;13148;13125;23;9;4308201003001.0
Rio Grande do Sul;Área 002;13969;13936;13925;12;33;4308201003002.0
Rio Grande do Sul;Garibaldi;30689;30660;30651;9;29;4308607.0
Rio Grande do Sul;Área 001;13840;13830;13830;0;10;4308607003001.0
Rio Grande do Sul;Área 002;16849;16829;16820;9;20;4308607003002.0
Rio Grande do Sul;Gramado;32273;32214;32192;23;59;4309100.0
Rio Grande do Sul;Área 001;12668;12660;12648;12;8;4309100003001.0
Rio Grande do Sul;Área 002;19605;19554;19543;10;51;4309100003002.0
Rio Grande do Sul;Gravataí;255660;255261;255113;148;399;4309209.0
Rio Grande do Sul;Águas-Claras;15516;15508;15489;20;8;4309209005008.0
Rio Grande do Sul;Barro-Vermelho;19688;19655;19655;0;33;4309209005006.0
Rio Grande do Sul;Central;14952;14952;14939;13;0;4309209005010.0
Rio Grande do Sul;Centro-1;11614;11567;11567;0;47;4309209005014.0
Rio Grande do Sul;Centro-2;18753;18722;18722;0;31;4309209005015.0
Rio Grande do Sul;Cohab;12732;12711;12711;0;21;4309209005004.0
Rio Grande do Sul;Itacolomi;15088;15052;15052;0;36;4309209005007.0
Rio Grande do Sul;Moradas;22594;22552;22530;22;42;4309209005001.0
Rio Grande do Sul;Morungava-Ipiranga;12469;12428;12412;16;41;4309209005013.0
Rio Grande do Sul;Parque-Dos-Anjos;21456;21404;21404;0;52;4309209005005.0
Rio Grande do Sul;Parque-Florido;19206;19183;19183;0;23;4309209005003.0
Rio Grande do Sul;São-Geraldo;20333;20323;20300;23;10;4309209005002.0
Rio Grande do Sul;São-Jeronimo;15379;15347;15347;0;32;4309209005011.0
Rio Grande do Sul;São-Vicente;20037;20026;19979;47;11;4309209005012.0
Rio Grande do Sul;Vila-Branca;15843;15830;15822;8;13;4309209005009.0
Rio Grande do Sul;Guaíba;95204;95052;95030;22;152;4309308.0
Rio Grande do Sul;Área 001;12825;12806;12806;0;19;4309308003001.0
Rio Grande do Sul;Área 002;11789;11751;11739;12;38;4309308003002.0
Rio Grande do Sul;Área 003;14208;14197;14197;0;11;4309308003003.0
Rio Grande do Sul;Área 004;26170;26151;26151;0;19;4309308003004.0
Rio Grande do Sul;Área 005;30212;30146;30136;10;66;4309308003005.0
Rio Grande do Sul;Igrejinha;31660;31660;31652;8;0;4310108.0
Rio Grande do Sul;Área 001;13621;13621;13621;0;0;4310108003001.0
Rio Grande do Sul;Área 002;18039;18039;18031;8;0;4310108003002.0
Rio Grande do Sul;Ijuí;78915;78881;78789;92;34;4310207.0
Rio Grande do Sul;Área 001;12700;12700;12690;10;0;4310207003001.0
Rio Grande do Sul;Área 002;13413;13390;13359;31;23;4310207003002.0
Rio Grande do Sul;Área 003;14036;14036;13997;39;0;4310207003003.0
Rio Grande do Sul;Área 004;19560;19560;19548;12;0;4310207003004.0
Rio Grande do Sul;Área 005;19206;19195;19195;0;11;4310207003005.0
Rio Grande do Sul;Itaqui;38159;38123;38104;19;36;4310603.0
Rio Grande do Sul;Área 001;13470;13457;13457;0;13;4310603003001.0
Rio Grande do Sul;Área 002;24689;24667;24647;19;22;4310603003002.0
Rio Grande do Sul;Jaguarão;27931;27190;27039;152;741;4311007.0
Rio Grande do Sul;Área 001;10437;10111;10043;68;326;4311007003001.0
Rio Grande do Sul;Área 002;17494;17079;16995;83;415;4311007003002.0
Rio Grande do Sul;Lagoa Vermelha;27525;27525;27513;12;0;4311304.0
Rio Grande do Sul;Área 001;12265;12265;12265;0;0;4311304003001.0
Rio Grande do Sul;Área 002;15260;15260;15248;12;0;4311304003002.0
Rio Grande do Sul;Lajeado;71445;71360;71275;85;85;4311403.0
Rio Grande do Sul;Área 001;11451;11441;11418;23;10;4311403003001.0
Rio Grande do Sul;Área 002;14423;14423;14423;0;0;4311403003002.0
Rio Grande do Sul;Área 003;19924;19900;19891;9;24;4311403003003.0
Rio Grande do Sul;Área 004;25647;25596;25543;53;51;4311403003004.0
Rio Grande do Sul;Marau;36364;36353;36311;42;11;4311809.0
Rio Grande do Sul;Área 001;11722;11722;11680;42;0;4311809003001.0
Rio Grande do Sul;Área 002;24642;24631;24631;0;11;4311809003002.0
Rio Grande do Sul;Montenegro;59415;59332;59298;34;83;4312401.0
Rio Grande do Sul;Área 001;15749;15749;15749;0;0;4312401003001.0
Rio Grande do Sul;Área 002;21083;21022;20997;24;61;4312401003002.0
Rio Grande do Sul;Área 003;22583;22561;22552;9;22;4312401003003.0
Rio Grande do Sul;Novo Hamburgo;238940;238591;238493;98;349;4313409.0
Rio Grande do Sul;Área 001;13988;13952;13943;9;36;4313409004001.0
Rio Grande do Sul;Área 002;15953;15946;15935;11;7;4313409004002.0
Rio Grande do Sul;Área 003;14767;14729;14720;8;38;4313409004003.0
Rio Grande do Sul;Área 004;17415;17415;17415;0;0;4313409004004.0
Rio Grande do Sul;Área 005;10900;10861;10851;10;39;4313409004005.0
Rio Grande do Sul;Área 006;11908;11882;11874;8;26;4313409004006.0
Rio Grande do Sul;Área 007;19526;19526;19526;0;0;4313409004007.0
Rio Grande do Sul;Área 008;18043;18006;17995;11;37;4313409004008.0
Rio Grande do Sul;Área 009;17707;17602;17594;8;105;4313409004009.0
Rio Grande do Sul;Área 010;12572;12572;12572;0;0;4313409004010.0
Rio Grande do Sul;Área 011;11254;11216;11205;11;38;4313409004011.0
Rio Grande do Sul;Área 012;20589;20578;20578;0;11;4313409004012.0
Rio Grande do Sul;Área 013;22234;22234;22222;12;0;4313409004013.0
Rio Grande do Sul;Área 014;32084;32073;32062;11;11;4313409004014.0
Rio Grande do Sul;Osório;40906;40885;40864;21;21;4313508.0
Rio Grande do Sul;Área 001;20075;20054;20043;11;21;4313508003001.0
Rio Grande do Sul;Área 002;20831;20831;20821;10;0;4313508003002.0
Rio Grande do Sul;Palmeira das Missões;34328;34328;34328;0;0;4313706.0
Rio Grande do Sul;Área 001;15430;15430;15430;0;0;4313706003001.0
Rio Grande do Sul;Área 002;18898;18898;18898;0;0;4313706003002.0
Rio Grande do Sul;Panambi;38058;38026;38005;21;32;4313904.0
Rio Grande do Sul;Área 001;17484;17484;17484;0;0;4313904003001.0
Rio Grande do Sul;Área 002;20574;20542;20521;21;32;4313904003002.0
Rio Grande do Sul;Parobé;51502;51469;51459;9;33;4314050.0
Rio Grande do Sul;Área 001;17423;17423;17423;0;0;4314050003001.0
Rio Grande do Sul;Área 002;34079;34046;34036;9;33;4314050003002.0
Rio Grande do Sul;Passo Fundo;184826;184541;184493;48;285;4314100.0
Rio Grande do Sul;Área 001;12547;12535;12535;0;12;4314100003001.0
Rio Grande do Sul;Área 002;18355;18355;18355;0;0;4314100003002.0
Rio Grande do Sul;Área 003;13157;13157;13157;0;0;4314100003003.0
Rio Grande do Sul;Área 004;25259;25118;25111;6;141;4314100003004.0
Rio Grande do Sul;Área 005;15052;15032;15032;0;20;4314100003005.0
Rio Grande do Sul;Área 006;17388;17377;17377;0;11;4314100003006.0
Rio Grande do Sul;Área 007;15109;15109;15109;0;0;4314100003007.0
Rio Grande do Sul;Área 008;12297;12276;12268;9;21;4314100003008.0
Rio Grande do Sul;Área 009;18659;18626;18616;10;33;4314100003009.0
Rio Grande do Sul;Área 010;37003;36956;36933;23;47;4314100003010.0
Rio Grande do Sul;Pelotas;328275;327576;327289;287;699;4314407.0
Rio Grande do Sul;Área 001;11973;11973;11973;0;0;4314407004001.0
Rio Grande do Sul;Área 002;13106;13106;13106;0;0;4314407004002.0
Rio Grande do Sul;Área 003;12758;12744;12719;25;14;4314407004003.0
Rio Grande do Sul;Área 004;14201;14131;14112;18;70;4314407004004.0
Rio Grande do Sul;Área 005;16052;16052;16052;0;0;4314407004005.0
Rio Grande do Sul;Área 006;13990;13977;13977;0;13;4314407004006.0
Rio Grande do Sul;Área 007;14801;14777;14777;0;24;4314407004007.0
Rio Grande do Sul;Área 008;14043;14043;14043;0;0;4314407004008.0
Rio Grande do Sul;Área 009;17143;17121;17121;0;22;4314407004009.0
Rio Grande do Sul;Área 010;12502;12502;12481;21;0;4314407004010.0
Rio Grande do Sul;Área 011;22576;22558;22558;0;18;4314407004011.0
Rio Grande do Sul;Área 012;19324;19258;19247;11;66;4314407004012.0
Rio Grande do Sul;Área 013;17232;17191;17160;31;41;4314407004013.0
Rio Grande do Sul;Área 014;21624;21572;21552;20;52;4314407004014.0
Rio Grande do Sul;Área 015;10207;10159;10127;32;48;4314407004015.0
Rio Grande do Sul;Área 016;19865;19809;19733;77;56;4314407004016.0
Rio Grande do Sul;Área 017;9844;9695;9687;8;149;4314407004017.0
Rio Grande do Sul;Área 018;18336;18284;18253;31;52;4314407004018.0
Rio Grande do Sul;Área 019;21575;21526;21526;0;49;4314407004019.0
Rio Grande do Sul;Área 020;27123;27097;27084;13;26;4314407004020.0
Rio Grande do Sul;Portão;30920;30810;30810;0;110;4314803.0
Rio Grande do Sul;Área 001;13094;13024;13024;0;70;4314803003001.0
Rio Grande do Sul;Área 002;17826;17786;17786;0;40;4314803003002.0
Rio Grande do Sul;Porto Alegre;1409351;1403450;1400506;2945;5901;4314902.0
Rio Grande do Sul;Área 001;16226;16198;16198;0;28;4314902004001.0
Rio Grande do Sul;Área 002;23596;23544;23449;94;52;4314902004002.0
Rio Grande do Sul;Área 003;22627;22563;22543;20;64;4314902004003.0
Rio Grande do Sul;Área 004;22226;22141;22040;101;85;4314902004004.0
Rio Grande do Sul;Área 005;170027;169240;168838;402;787;4314902004005.0
Rio Grande do Sul;Área 006;22322;22286;22260;27;36;4314902004006.0
Rio Grande do Sul;Área 007;24788;24737;24716;22;51;4314902004007.0
Rio Grande do Sul;Área 008;23761;23640;23597;43;121;4314902004008.0
Rio Grande do Sul;Área 009;28850;28823;28801;21;27;4314902004009.0
Rio Grande do Sul;Área 010;20089;19985;19934;52;104;4314902004010.0
Rio Grande do Sul;Área 011;21023;20859;20817;42;164;4314902004011.0
Rio Grande do Sul;Área 012;18362;18165;18071;95;197;4314902004012.0
Rio Grande do Sul;Área 013;51998;51267;50880;386;731;4314902004013.0
Rio Grande do Sul;Área 014;17881;17585;17490;95;296;4314902004014.0
Rio Grande do Sul;Área 015;27067;26991;26952;39;76;4314902004015.0
Rio Grande do Sul;Área 016;22278;22118;22018;100;160;4314902004016.0
Rio Grande do Sul;Área 017;19238;19134;19134;0;104;4314902004017.0
Rio Grande do Sul;Área 018;22280;22177;21980;197;103;4314902004018.0
Rio Grande do Sul;Área 019;24698;24458;24302;155;240;4314902004019.0
Rio Grande do Sul;Área 020;40568;40508;40493;14;60;4314902004020.0
Rio Grande do Sul;Área 021;24554;24320;24247;73;234;4314902004021.0
Rio Grande do Sul;Área 022;30057;29860;29841;19;197;4314902004022.0
Rio Grande do Sul;Área 023;34497;34451;34379;72;46;4314902004023.0
Rio Grande do Sul;Área 024;43242;43083;43047;36;159;4314902004024.0
Rio Grande do Sul;Área 025;30092;30029;30029;0;63;4314902004025.0
Rio Grande do Sul;Área 026;24433;24418;24402;15;15;4314902004026.0
Rio Grande do Sul;Área 027;43574;43548;43548;0;26;4314902004027.0
Rio Grande do Sul;Área 028;27587;27518;27475;43;69;4314902004028.0
Rio Grande do Sul;Área 029;20973;20932;20924;8;41;4314902004029.0
Rio Grande do Sul;Área 030;28688;28471;28439;33;217;4314902004030.0
Rio Grande do Sul;Área 031;26214;26084;25983;100;130;4314902004031.0
Rio Grande do Sul;Área 032;33217;32750;32515;235;467;4314902004032.0
Rio Grande do Sul;Área 033;28817;28796;28725;72;21;4314902004033.0
Rio Grande do Sul;Área 034;26507;26397;26378;19;110;4314902004034.0
Rio Grande do Sul;Área 035;25311;25218;25144;74;93;4314902004035.0
Rio Grande do Sul;Área 036;42319;42088;42071;18;231;4314902004036.0
Rio Grande do Sul;Área 037;37347;37283;37273;10;64;4314902004037.0
Rio Grande do Sul;Área 038;26862;26825;26825;0;37;4314902004038.0
Rio Grande do Sul;Área 039;59490;59450;59410;40;40;4314902004039.0
Rio Grande do Sul;Área 040;32748;32697;32697;0;51;4314902004040.0
Rio Grande do Sul;Área 041;58233;58192;58097;95;41;4314902004041.0
Rio Grande do Sul;Área 042;64684;64621;64542;78;63;4314902004042.0
Rio Grande do Sul;Rio Grande;197228;196840;196676;164;388;4315602.0
Rio Grande do Sul;Área 001;12218;12209;12209;0;9;4315602004001.0
Rio Grande do Sul;Área 002;11971;11953;11953;0;18;4315602004002.0
Rio Grande do Sul;Área 003;17138;17117;17109;8;21;4315602004003.0
Rio Grande do Sul;Área 004;21137;21082;21044;38;55;4315602004004.0
Rio Grande do Sul;Área 005;13760;13732;13729;3;28;4315602004005.0
Rio Grande do Sul;Área 006;22369;22289;22259;31;80;4315602004006.0
Rio Grande do Sul;Área 007;15784;15656;15598;57;128;4315602004007.0
Rio Grande do Sul;Área 008;11996;11988;11980;8;8;4315602004008.0
Rio Grande do Sul;Área 009;14532;14499;14479;20;33;4315602004009.0
Rio Grande do Sul;Área 010;22513;22513;22513;0;0;4315602004010.0
Rio Grande do Sul;Área 011;33810;33802;33802;0;8;4315602004011.0
Rio Grande do Sul;Rio Pardo;37591;37569;37559;10;22;4315701.0
Rio Grande do Sul;Área 001;17727;17705;17705;0;22;4315701003001.0
Rio Grande do Sul;Área 002;19864;19864;19854;10;0;4315701003002.0
Rio Grande do Sul;Rosário do Sul;39707;39688;39655;33;19;4316402.0
Rio Grande do Sul;Área 001;14734;14734;14710;24;0;4316402003001.0
Rio Grande do Sul;Área 002;24973;24954;24944;10;19;4316402003002.0
Rio Grande do Sul;Santa Cruz do Sul;118374;118125;118095;30;249;4316808.0
Rio Grande do Sul;Área 001;12488;12488;12488;0;0;4316808003001.0
Rio Grande do Sul;Área 002;14577;14553;14553;0;24;4316808003002.0
Rio Grande do Sul;Área 003;34758;34675;34644;30;83;4316808003003.0
Rio Grande do Sul;Área 004;14113;14113;14113;0;0;4316808003004.0
Rio Grande do Sul;Área 005;20140;20134;20134;0;6;4316808003005.0
Rio Grande do Sul;Área 006;22298;22163;22163;0;135;4316808003006.0
Rio Grande do Sul;Santa Maria;261031;260715;260558;157;316;4316907.0
Rio Grande do Sul;Área 001;11915;11915;11915;0;0;4316907004001.0
Rio Grande do Sul;Área 002;13855;13820;13800;21;35;4316907004002.0
Rio Grande do Sul;Área 003;13638;13592;13573;19;46;4316907004003.0
Rio Grande do Sul;Área 004;13458;13458;13458;0;0;4316907004004.0
Rio Grande do Sul;Área 005;14158;14145;14145;0;13;4316907004005.0
Rio Grande do Sul;Área 006;15753;15753;15753;0;0;4316907004006.0
Rio Grande do Sul;Área 007;17236;17236;17236;0;0;4316907004007.0
Rio Grande do Sul;Área 008;22047;21981;21963;18;66;4316907004008.0
Rio Grande do Sul;Área 009;13626;13619;13602;17;7;4316907004009.0
Rio Grande do Sul;Área 010;19700;19652;19652;0;48;4316907004010.0
Rio Grande do Sul;Área 011;10634;10549;10508;41;85;4316907004011.0
Rio Grande do Sul;Área 012;17416;17416;17416;0;0;4316907004012.0
Rio Grande do Sul;Área 013;13697;13685;13685;0;12;4316907004013.0
Rio Grande do Sul;Área 014;10767;10761;10744;17;6;4316907004014.0
Rio Grande do Sul;Área 015;25131;25131;25106;25;0;4316907004015.0
Rio Grande do Sul;Área 016;28000;28000;28000;0;0;4316907004016.0
Rio Grande do Sul;Santa Rosa;68587;68517;68438;80;70;4317202.0
Rio Grande do Sul;Área 001;11830;11830;11810;20;0;4317202003001.0
Rio Grande do Sul;Área 002;11774;11744;11725;20;30;4317202003002.0
Rio Grande do Sul;Área 003;20083;20063;20041;21;20;4317202003003.0
Rio Grande do Sul;Área 004;24900;24880;24861;19;20;4317202003004.0
Rio Grande do Sul;Santa Vitória do Palmar;30990;30267;30170;97;723;4317301.0
Rio Grande do Sul;Área 001;13110;12459;12422;37;651;4317301003001.0
Rio Grande do Sul;Área 002;17880;17808;17748;60;72;4317301003002.0
Rio Grande do Sul;Sant'Ana do Livramento;82464;78654;77375;1279;3810;4317103.0
Rio Grande do Sul;Área 001;12283;11579;11356;223;704;4317103003001.0
Rio Grande do Sul;Área 002;12717;12483;12388;95;234;4317103003002.0
Rio Grande do Sul;Área 003;13204;12721;12545;175;483;4317103003003.0
Rio Grande do Sul;Área 004;22298;21770;21600;171;528;4317103003004.0
Rio Grande do Sul;Área 005;21962;20101;19485;616;1861;4317103003005.0
Rio Grande do Sul;Santiago;49071;49053;49053;0;18;4317400.0
Rio Grande do Sul;Área 001;11331;11331;11331;0;0;4317400003001.0
Rio Grande do Sul;Área 002;15292;15283;15283;0;9;4317400003002.0
Rio Grande do Sul;Área 003;22448;22439;22439;0;9;4317400003003.0
Rio Grande do Sul;Santo Ângelo;76275;76238;76209;28;37;4317509.0
Rio Grande do Sul;Área 001;15866;15866;15866;0;0;4317509003001.0
Rio Grande do Sul;Área 002;12311;12292;12273;19;19;4317509003002.0
Rio Grande do Sul;Área 003;22932;22932;22923;9;0;4317509003003.0
Rio Grande do Sul;Área 004;25166;25147;25147;0;19;4317509003004.0
Rio Grande do Sul;Santo Antônio da Patrulha;39685;39685;39685;0;0;4317608.0
Rio Grande do Sul;Área 001;19592;19592;19592;0;0;4317608003001.0
Rio Grande do Sul;Área 002;20093;20093;20093;0;0;4317608003002.0
Rio Grande do Sul;São Borja;61671;61620;61551;69;51;4318002.0
Rio Grande do Sul;Área 001;13747;13735;13735;0;12;4318002003001.0
Rio Grande do Sul;Área 002;22081;22068;22027;40;13;4318002003002.0
Rio Grande do Sul;Área 003;25843;25817;25788;29;26;4318002003003.0
Rio Grande do Sul;São Gabriel;60425;60356;60332;25;69;4318309.0
Rio Grande do Sul;Área 001;11810;11795;11795;0;15;4318309003001.0
Rio Grande do Sul;Área 002;19639;19614;19598;16;25;4318309003002.0
Rio Grande do Sul;Área 003;28976;28948;28939;8;28;4318309003003.0
Rio Grande do Sul;São José do Norte;25503;25494;25483;11;9;4318507.0
Rio Grande do Sul;Área 001;12557;12548;12537;11;9;4318507003001.0
Rio Grande do Sul;Área 002;12946;12946;12946;0;0;4318507003002.0
Rio Grande do Sul;São Leopoldo;214087;213605;213442;163;482;4318705.0
Rio Grande do Sul;Arroio da Manteiga;23988;23976;23969;7;12;4318705005013.0
Rio Grande do Sul;Campestre;13376;13344;13344;0;32;4318705005003.0
Rio Grande do Sul;Campina;13599;13576;13550;26;23;4318705005008.0
Rio Grande do Sul;Centro;19767;19601;19566;35;166;4318705005007.0
Rio Grande do Sul;Duque de Caxias;13112;13112;13112;0;0;4318705005004.0
Rio Grande do Sul;Feitoria Norte;15312;15312;15312;0;0;4318705005001.0
Rio Grande do Sul;Feitoria Sul;21496;21464;21464;0;32;4318705005002.0
Rio Grande do Sul;Jardim América;12876;12829;12819;10;47;4318705005005.0
Rio Grande do Sul;Pinheiro;13518;13410;13393;17;108;4318705005006.0
Rio Grande do Sul;Rio dos Sinos;15293;15284;15276;8;9;4318705005009.0
Rio Grande do Sul;Santos Dumont Norte;13955;13955;13921;34;0;4318705005010.0
Rio Grande do Sul;Scharlau;14456;14434;14408;26;22;4318705005011.0
Rio Grande do Sul;Vicentina;23339;23308;23308;0;31;4318705005012.0
Rio Grande do Sul;São Lourenço do Sul;43111;43102;43092;10;9;4318804.0
Rio Grande do Sul;Área 001;16115;16106;16106;0;9;4318804003001.0
Rio Grande do Sul;Área 002;26996;26996;26986;10;0;4318804003002.0
Rio Grande do Sul;São Luiz Gonzaga;34556;34556;34556;0;0;4318903.0
Rio Grande do Sul;Área 001;11991;11991;11991;0;0;4318903003001.0
Rio Grande do Sul;Área 002;22565;22565;22565;0;0;4318903003002.0
Rio Grande do Sul;Sapiranga;74985;74957;74938;19;28;4319901.0
Rio Grande do Sul;Área 001;12689;12689;12689;0;0;4319901003001.0
Rio Grande do Sul;Área 002;15021;15021;15021;0;0;4319901003002.0
Rio Grande do Sul;Área 003;17006;16987;16987;0;19;4319901003003.0
Rio Grande do Sul;Área 004;30269;30259;30240;19;10;4319901003004.0
Rio Grande do Sul;Sapucaia do Sul;130957;130906;130833;74;51;4320008.0
Rio Grande do Sul;Área 001;16179;16165;16165;0;14;4320008003001.0
Rio Grande do Sul;Área 002;12712;12704;12691;13;8;4320008003002.0
Rio Grande do Sul;Área 003;13220;13208;13208;0;12;4320008003003.0
Rio Grande do Sul;Área 004;14095;14078;14067;11;17;4320008003004.0
Rio Grande do Sul;Área 005;18312;18312;18277;35;0;4320008003005.0
Rio Grande do Sul;Área 006;25814;25814;25814;0;0;4320008003006.0
Rio Grande do Sul;Área 007;30625;30625;30610;15;0;4320008003007.0
Rio Grande do Sul;Soledade;30044;30030;30030;0;14;4320800.0
Rio Grande do Sul;Área 001;12529;12529;12529;0;0;4320800003001.0
Rio Grande do Sul;Área 002;17515;17501;17501;0;14;4320800003002.0
Rio Grande do Sul;Taquara;54643;54571;54517;54;72;4321204.0
Rio Grande do Sul;Área 001;12406;12371;12371;0;35;4321204003001.0
Rio Grande do Sul;Área 002;21493;21484;21484;0;9;4321204003002.0
Rio Grande do Sul;Área 003;20744;20716;20662;54;28;4321204003003.0
Rio Grande do Sul;Taquari;26092;26092;26092;0;0;4321303.0
Rio Grande do Sul;Área 001;11722;11722;11722;0;0;4321303003001.0
Rio Grande do Sul;Área 002;14370;14370;14370;0;0;4321303003002.0
Rio Grande do Sul;Teutônia;27272;27222;27222;0;50;4321451.0
Rio Grande do Sul;Área 001;12151;12151;12151;0;0;4321451003001.0
Rio Grande do Sul;Área 002;15121;15071;15071;0;50;4321451003002.0
Rio Grande do Sul;Torres;34656;34604;34555;49;52;4321501.0
Rio Grande do Sul;Área 001;17130;17099;17072;28;31;4321501003001.0
Rio Grande do Sul;Área 002;17526;17505;17484;21;21;4321501003002.0
Rio Grande do Sul;Tramandaí;41585;41527;41503;24;58;4321600.0
Rio Grande do Sul;Área 001;22277;22246;22246;0;31;4321600003001.0
Rio Grande do Sul;Área 002;19308;19281;19257;24;27;4321600003002.0
Rio Grande do Sul;Triunfo;25793;25787;25783;4;6;4322004.0
Rio Grande do Sul;Área 001;12916;12910;12910;0;6;4322004003001.0
Rio Grande do Sul;Área 002;12877;12877;12873;4;0;4322004003002.0
Rio Grande do Sul;Uruguaiana;125435;124921;124658;263;514;4322400.0
Rio Grande do Sul;Área 001;14990;14958;14943;15;32;4322400003001.0
Rio Grande do Sul;Área 002;16333;16229;16183;47;104;4322400003002.0
Rio Grande do Sul;Área 003;14182;14108;14024;83;74;4322400003003.0
Rio Grande do Sul;Área 004;17019;16974;16962;11;45;4322400003004.0
Rio Grande do Sul;Área 005;29383;29282;29232;51;101;4322400003005.0
Rio Grande do Sul;Área 006;33528;33370;33313;56;158;4322400003006.0
Rio Grande do Sul;Vacaria;61342;61315;61306;9;27;4322509.0
Rio Grande do Sul;Área 001;12029;12013;12013;0;16;4322509003001.0
Rio Grande do Sul;Área 002;23755;23755;23755;0;0;4322509003002.0
Rio Grande do Sul;Área 003;25558;25547;25538;9;11;4322509003003.0
Rio Grande do Sul;Venâncio Aires;65946;65908;65886;22;38;4322608.0
Rio Grande do Sul;Área 001;10582;10557;10546;11;25;4322608003001.0
Rio Grande do Sul;Área 002;12529;12515;12515;0;14;4322608003002.0
Rio Grande do Sul;Área 003;20711;20711;20700;11;0;4322608003003.0
Rio Grande do Sul;Área 004;22124;22124;22124;0;0;4322608003004.0
Rio Grande do Sul;Viamão;239384;239065;238846;219;319;4323002.0
Rio Grande do Sul;Área 001;13440;13432;13393;39;8;4323002004001.0
Rio Grande do Sul;Área 002;73487;73437;73378;59;50;4323002004002.0
Rio Grande do Sul;Área 003;14773;14759;14735;24;14;4323002004003.0
Rio Grande do Sul;Área 004;14926;14907;14907;0;19;4323002004004.0
Rio Grande do Sul;Área 005;17381;17368;17368;0;13;4323002004005.0
Rio Grande do Sul;Área 006;13986;13931;13906;25;55;4323002004006.0
Rio Grande do Sul;Área 007;19550;19470;19470;0;80;4323002004007.0
Rio Grande do Sul;Área 008;16181;16168;16139;29;13;4323002004008.0
Rio Grande do Sul;Área 009;14036;14006;14006;0;30;4323002004009.0
Rio Grande do Sul;Área 010;15286;15286;15267;19;0;4323002004010.0
Rio Grande do Sul;Área 011;26338;26299;26276;24;39;4323002004011.0
Mato Grosso do Sul;Amambai;34730;34668;34601;67;62;5000609.0
Mato Grosso do Sul;Área 001;17608;17587;17551;36;21;5000609003001.0
Mato Grosso do Sul;Área 002;17122;17081;17050;31;41;5000609003002.0
Mato Grosso do Sul;Aquidauana;45614;45455;45339;116;159;5001102.0
Mato Grosso do Sul;Área 001;21892;21846;21777;70;46;5001102003001.0
Mato Grosso do Sul;Área 002;23722;23609;23562;47;113;5001102003002.0
Mato Grosso do Sul;Campo Grande;786797;785017;782969;2047;1780;5002704.0
Mato Grosso do Sul;Região Urbana do Anhanduizinho;185558;185183;184685;498;375;5002704005001.0
Mato Grosso do Sul;Região Urbana do Bandeira;113118;112834;112600;234;284;5002704005002.0
Mato Grosso do Sul;Região Urbana do Centro;71037;70773;70472;301;264;5002704005003.0
Mato Grosso do Sul;Região Urbana do Imbirussu;98752;98535;98320;216;217;5002704005004.0
Mato Grosso do Sul;Região Urbana do Lagoa;114447;114228;113992;236;219;5002704005005.0
Mato Grosso do Sul;Região Urbana do Prosa;82328;81995;81694;302;333;5002704005006.0
Mato Grosso do Sul;Região Urbana do Segredo;108962;108901;108649;252;61;5002704005007.0
Mato Grosso do Sul;Zona Rural;12595;12566;12557;9;29;5002704005008.0
Mato Grosso do Sul;Corumbá;103703;102967;102421;546;736;5003207.0
Mato Grosso do Sul;Área 001;16357;16216;16146;70;141;5003207003001.0
Mato Grosso do Sul;Área 002;16266;16238;16227;12;28;5003207003002.0
Mato Grosso do Sul;Área 003;26511;26240;26038;202;271;5003207003003.0
Mato Grosso do Sul;Área 004;44569;44272;44010;262;297;5003207003004.0
Mato Grosso do Sul;Coxim;32159;32112;32101;10;47;5003306.0
Mato Grosso do Sul;Área 001;13463;13416;13405;10;47;5003306003001.0
Mato Grosso do Sul;Área 002;18696;18696;18696;0;0;5003306003002.0
Mato Grosso do Sul;Dourados;196035;195698;195373;326;337;5003702.0
Mato Grosso do Sul;Cachoerinha;18328;18305;18276;29;23;5003702005001.0
Mato Grosso do Sul;Centro;16791;16716;16649;67;75;5003702005009.0
Mato Grosso do Sul;Flórida;19617;19587;19587;0;30;5003702005003.0
Mato Grosso do Sul;IV Plano;15352;15325;15266;59;27;5003702005002.0
Mato Grosso do Sul;Izidro Pedroso;22042;21997;21964;32;45;5003702005004.0
Mato Grosso do Sul;Monte Líbano;19533;19473;19447;26;60;5003702005006.0
Mato Grosso do Sul;Parque Alvorada;14832;14811;14735;76;21;5003702005008.0
Mato Grosso do Sul;Parque das Nações;32929;32922;32909;12;7;5003702005005.0
Mato Grosso do Sul;Rural;23185;23172;23149;23;13;5003702005010.0
Mato Grosso do Sul;Santa Brígida;13426;13390;13390;0;36;5003702005007.0
Mato Grosso do Sul;Maracaju;37405;37206;37072;134;199;5005400.0
Mato Grosso do Sul;Área 001;14703;14654;14602;52;49;5005400003001.0
Mato Grosso do Sul;Área 002;22702;22552;22470;82;150;5005400003002.0
Mato Grosso do Sul;Naviraí;46424;46382;46204;179;42;5005707.0
Mato Grosso do Sul;Área 001;16753;16743;16691;53;10;5005707003001.0
Mato Grosso do Sul;Área 002;29671;29639;29513;126;32;5005707003002.0
Mato Grosso do Sul;Nova Andradina;45585;45500;45402;98;85;5006200.0
Mato Grosso do Sul;Área 001;22437;22406;22339;67;31;5006200003001.0
Mato Grosso do Sul;Área 002;23148;23094;23063;31;54;5006200003002.0
Mato Grosso do Sul;Paranaíba;40192;40137;40122;16;55;5006309.0
Mato Grosso do Sul;Área 001;14253;14227;14227;0;26;5006309003001.0
Mato Grosso do Sul;Área 002;25939;25911;25895;16;28;5006309003002.0
Mato Grosso do Sul;Ponta Porã;77872;75733;75114;619;2139;5006606.0
Mato Grosso do Sul;Área 001;14849;14370;14287;84;479;5006606003001.0
Mato Grosso do Sul;Área 002;15194;15164;15055;109;30;5006606003002.0
Mato Grosso do Sul;Área 003;22957;21975;21755;220;982;5006606003003.0
Mato Grosso do Sul;Área 004;24872;24223;24017;206;649;5006606003004.0
Mato Grosso do Sul;Sidrolândia;42132;42046;41977;69;86;5007901.0
Mato Grosso do Sul;Área 001;15037;15027;14968;59;10;5007901003001.0
Mato Grosso do Sul;Área 002;27095;27019;27009;10;76;5007901003002.0
Mato Grosso do Sul;Três Lagoas;101791;101658;101535;123;133;5008305.0
Mato Grosso do Sul;Área 001;16344;16333;16302;31;11;5008305003001.0
Mato Grosso do Sul;Área 002;22998;22958;22945;12;40;5008305003002.0
Mato Grosso do Sul;Área 003;25410;25389;25369;21;21;5008305003003.0
Mato Grosso do Sul;Área 004;37039;36978;36919;59;61;5008305003004.0
Mato Grosso;Alta Floresta;49164;49124;49078;46;40;5100250.0
Mato Grosso;Área 001;25099;25073;25073;0;26;5100250003001.0
Mato Grosso;Área 002;24065;24051;24004;46;14;5100250003002.0
Mato Grosso;Barra do Bugres;31793;31756;31743;13;37;5101704.0
Mato Grosso;Área 001;14963;14963;14963;0;0;5101704003001.0
Mato Grosso;Área 002;16830;16793;16780;13;37;5101704003002.0
Mato Grosso;Barra do Garças;56560;56526;56499;27;34;5101803.0
Mato Grosso;Área 001;15346;15346;15346;0;0;5101803003001.0
Mato Grosso;Área 002;19432;19405;19397;7;27;5101803003002.0
Mato Grosso;Área 003;21782;21775;21755;20;7;5101803003003.0
Mato Grosso;Cáceres;87942;87607;87532;75;335;5102504.0
Mato Grosso;Área 001;17112;17070;17059;11;42;5102504003001.0
Mato Grosso;Área 002;14723;14669;14661;8;54;5102504003002.0
Mato Grosso;Área 003;26192;26065;26054;10;127;5102504003003.0
Mato Grosso;Área 004;29915;29804;29758;46;111;5102504003004.0
Mato Grosso;Campo Verde;31589;31465;31415;49;124;5102678.0
Mato Grosso;Área 001;13957;13890;13890;0;67;5102678003001.0
Mato Grosso;Área 002;17632;17575;17526;49;57;5102678003002.0
Mato Grosso;Cuiabá;551098;550726;550286;440;372;5103403.0
Mato Grosso;Área 001;33706;33688;33688;0;18;5103403005001.0
Mato Grosso;Área 002;28651;28631;28631;0;20;5103403005002.0
Mato Grosso;Área 003;28545;28526;28511;15;19;5103403005003.0
Mato Grosso;Área 004;29105;29004;28973;32;101;5103403005004.0
Mato Grosso;Área 005;29887;29871;29828;42;16;5103403005005.0
Mato Grosso;Área 006;30595;30595;30478;117;0;5103403005006.0
Mato Grosso;Área 007;32042;32042;32042;0;0;5103403005007.0
Mato Grosso;Área 008;28248;28248;28248;0;0;5103403005008.0
Mato Grosso;Área 009;36936;36936;36936;0;0;5103403005009.0
Mato Grosso;Área 010;36079;36061;36061;0;18;5103403005010.0
Mato Grosso;Área 011;28043;28019;27968;52;24;5103403005011.0
Mato Grosso;Área 012;27941;27849;27775;74;92;5103403005012.0
Mato Grosso;Área 013;29232;29232;29232;0;0;5103403005013.0
Mato Grosso;Área 014;44287;44287;44262;25;0;5103403005014.0
Mato Grosso;Área 015;32022;31980;31966;14;42;5103403005015.0
Mato Grosso;Área 016;26914;26914;26914;0;0;5103403005016.0
Mato Grosso;Área 017;36987;36964;36909;55;23;5103403005017.0
Mato Grosso;Área 018;11878;11878;11864;14;0;5103403005018.0
Mato Grosso;Guarantã do Norte;32216;32196;32176;21;20;5104104.0
Mato Grosso;Área 001;15098;15088;15088;0;10;5104104003001.0
Mato Grosso;Área 002;17118;17108;17087;21;10;5104104003002.0
Mato Grosso;Jaciara;25647;25626;25608;19;21;5104807.0
Mato Grosso;Área 001;12853;12832;12821;12;21;5104807003001.0
Mato Grosso;Área 002;12794;12794;12787;7;0;5104807003002.0
Mato Grosso;Juara;32791;32761;32727;33;30;5105101.0
Mato Grosso;Área 001;13118;13104;13086;18;14;5105101003001.0
Mato Grosso;Área 002;19673;19657;19641;16;16;5105101003002.0
Mato Grosso;Juína;39255;39236;39149;88;19;5105150.0
Mato Grosso;Área 001;15116;15097;15043;54;19;5105150003001.0
Mato Grosso;Área 002;24139;24139;24105;34;0;5105150003002.0
Mato Grosso;Lucas do Rio Verde;45556;45509;45467;42;47;5105259.0
Mato Grosso;Área 001;23357;23338;23317;21;19;5105259003001.0
Mato Grosso;Área 002;22199;22171;22151;21;28;5105259003002.0
Mato Grosso;Nova Mutum;31649;31612;31533;80;37;5106224.0
Mato Grosso;Área 001;13222;13204;13160;44;18;5106224003001.0
Mato Grosso;Área 002;18427;18409;18373;36;18;5106224003002.0
Mato Grosso;Pontes e Lacerda;41408;41384;41319;65;24;5106752.0
Mato Grosso;Área 001;15453;15444;15405;39;9;5106752003001.0
Mato Grosso;Área 002;25955;25939;25913;26;16;5106752003002.0
Mato Grosso;Primavera do Leste;52066;51943;51891;52;123;5107040.0
Mato Grosso;Área 001;25799;25749;25735;14;50;5107040003001.0
Mato Grosso;Área 002;26267;26194;26156;38;73;5107040003002.0
Mato Grosso;Rondonópolis;195476;195195;195034;161;281;5107602.0
Mato Grosso;Área 001;12531;12510;12468;42;21;5107602005001.0
Mato Grosso;Área 002;13866;13854;13813;41;12;5107602005002.0
Mato Grosso;Área 003;14641;14609;14600;9;32;5107602005003.0
Mato Grosso;Área 004;23582;23555;23543;12;27;5107602005004.0
Mato Grosso;Área 005;21789;21756;21746;10;33;5107602005005.0
Mato Grosso;Área 006;15838;15809;15798;11;29;5107602005006.0
Mato Grosso;Área 007;21138;21138;21138;0;0;5107602005007.0
Mato Grosso;Área 008;21050;20962;20962;0;88;5107602005008.0
Mato Grosso;Área 009;16522;16497;16497;0;25;5107602005009.0
Mato Grosso;Área 010;19673;19673;19657;16;0;5107602005010.0
Mato Grosso;Área 011;14846;14832;14812;20;14;5107602005011.0
Mato Grosso;Sinop;113099;112992;112798;195;107;5107909.0
Mato Grosso;Área 001;14922;14922;14900;22;0;5107909003001.0
Mato Grosso;Área 002;16336;16294;16287;6;42;5107909003002.0
Mato Grosso;Área 003;15261;15261;15238;23;0;5107909003003.0
Mato Grosso;Área 004;32157;32157;32103;54;0;5107909003004.0
Mato Grosso;Área 005;34423;34359;34269;90;64;5107909003005.0
Mato Grosso;Sorriso;66521;66465;66394;71;56;5107925.0
Mato Grosso;Área 001;13542;13505;13486;19;37;5107925003001.0
Mato Grosso;Área 002;20570;20570;20539;31;0;5107925003002.0
Mato Grosso;Área 003;32409;32390;32370;20;19;5107925003003.0
Mato Grosso;Tangará da Serra;83431;83318;83279;39;113;5107958.0
Mato Grosso;Área 001;13144;13134;13134;0;10;5107958003001.0
Mato Grosso;Área 002;13515;13471;13471;0;44;5107958003002.0
Mato Grosso;Área 003;23237;23222;23192;30;15;5107958003003.0
Mato Grosso;Área 004;33535;33491;33482;9;44;5107958003004.0
Mato Grosso;Várzea Grande;252596;252422;252266;156;174;5108402.0
Mato Grosso;Área 001;14815;14802;14789;12;13;5108402005001.0
Mato Grosso;Área 002;14116;14116;14106;10;0;5108402005002.0
Mato Grosso;Área 003;14608;14599;14580;19;9;5108402005003.0
Mato Grosso;Área 004;15209;15209;15209;0;0;5108402005004.0
Mato Grosso;Área 005;20735;20735;20727;8;0;5108402005005.0
Mato Grosso;Área 006;13751;13738;13731;7;13;5108402005006.0
Mato Grosso;Área 007;14303;14303;14303;0;0;5108402005007.0
Mato Grosso;Área 008;14864;14864;14864;0;0;5108402005008.0
Mato Grosso;Área 009;14879;14860;14845;15;19;5108402005009.0
Mato Grosso;Área 010;14573;14547;14531;16;26;5108402005010.0
Mato Grosso;Área 011;14473;14473;14461;12;0;5108402005011.0
Mato Grosso;Área 012;14368;14368;14368;0;0;5108402005012.0
Mato Grosso;Área 013;14188;14178;14170;8;10;5108402005013.0
Mato Grosso;Área 014;13708;13625;13615;10;83;5108402005014.0
Mato Grosso;Área 015;13915;13915;13915;0;0;5108402005015.0
Mato Grosso;Área 016;13641;13641;13638;3;0;5108402005016.0
Mato Grosso;Área 017;16450;16450;16414;36;0;5108402005017.0
Goiás;Águas Lindas de Goiás;159378;159315;159304;11;63;5200258.0
Goiás;Área 001;14727;14727;14727;0;0;5200258003001.0
Goiás;Área 002;14786;14766;14766;0;20;5200258003002.0
Goiás;Área 003;17722;17722;17722;0;0;5200258003003.0
Goiás;Área 004;18504;18494;18494;0;10;5200258003004.0
Goiás;Área 005;21886;21875;21875;0;11;5200258003005.0
Goiás;Área 006;28763;28752;28752;0;11;5200258003006.0
Goiás;Área 007;42990;42979;42968;11;11;5200258003007.0
Goiás;Anápolis;334613;333947;333593;353;666;5201108.0
Goiás;Bairro Boa Vista, Bairro São Carlos, Bairro Cidade Jardim;22697;22654;22647;8;43;5201108005009.0
Goiás;Bairro Jk, Jardim America, Vila Esperanca;49541;49384;49314;70;157;5201108005011.0
Goiás;Bairro Jundiai, Anapolis City, Vila Santa Maria;25467;25343;25325;19;124;5201108005010.0
Goiás;Bairro Maracana, Jardim Alexandrina, Jardim das Americas;34285;34215;34151;63;70;5201108005008.0
Goiás;Bairro Recanto do Sol, Parque dos Pirineus;25536;25525;25525;0;11;5201108005002.0
Goiás;Conjunto Filostro Machado, Bairro de Lourdes;21677;21651;21634;17;26;5201108005003.0
Goiás;Jardim Alvorada, Bairro Santo Antônio;14340;14313;14298;15;27;5201108005004.0
Goiás;Região Central, Fabril;35751;35695;35563;132;56;5201108005007.0
Goiás;Residencial São Vicente, Vivian Parque, Polocentro, Bairro Paraiso;30421;30411;30411;0;10;5201108005005.0
Goiás;Vila Gois, Setor Jamil Miguel, Jardim Nacoes Unidas;21354;21316;21295;21;38;5201108005006.0
Goiás;Vila Jayara, Adriana Parque;34991;34933;34933;0;58;5201108005001.0
Goiás;Zona Rural, Distritos, Daia;18553;18507;18498;8;46;5201108005012.0
Goiás;Aparecida de Goiânia;455657;455315;455109;206;342;5201405.0
Goiás;Região Centro;28983;28963;28941;21;20;5201405005001.0
Goiás;Região Cidade Livre;28875;28875;28849;26;0;5201405005003.0
Goiás;Região Cruzeiro do Sul;33960;33960;33960;0;0;5201405005008.0
Goiás;Região Garavelo;51121;51121;51121;0;0;5201405005012.0
Goiás;Região Independecia Mansoes;36512;36512;36512;0;0;5201405005004.0
Goiás;Região Jardim Bela Vista;41492;41439;41417;22;53;5201405005007.0
Goiás;Região Jardim Tiradentes;31335;31310;31310;0;25;5201405005010.0
Goiás;Região Jardim Tropical;41060;40995;40995;0;65;5201405005011.0
Goiás;Região Nova Era;31296;31296;31296;0;0;5201405005013.0
Goiás;Região Papilon Park;29768;29682;29682;0;86;5201405005009.0
Goiás;Região Pontal Sul;31646;31632;31632;0;14;5201405005005.0
Goiás;Região Vila Brasilia;37970;37918;37918;0;52;5201405005006.0
Goiás;Região Vila Souza;31639;31613;31476;137;26;5201405005002.0
Goiás;Caldas Novas;70473;70311;70153;158;162;5204508.0
Goiás;Área 001;13730;13676;13643;33;54;5204508003001.0
Goiás;Área 002;15577;15563;15563;0;14;5204508003002.0
Goiás;Área 003;18396;18368;18269;100;28;5204508003003.0
Goiás;Área 004;22770;22704;22678;26;66;5204508003004.0
Goiás;Catalão;86647;86608;86580;28;39;5205109.0
Goiás;Área 001;16866;16866;16855;11;0;5205109003001.0
Goiás;Área 002;17103;17072;17065;7;31;5205109003002.0
Goiás;Área 003;25257;25249;25240;9;8;5205109003003.0
Goiás;Área 004;27421;27421;27421;0;0;5205109003004.0
Goiás;Cidade Ocidental;55915;55899;55879;21;16;5205497.0
Goiás;Área 001;28608;28608;28587;21;0;5205497003001.0
Goiás;Área 002;27307;27291;27291;0;16;5205497003002.0
Goiás;Cristalina;46580;46548;46525;23;32;5206206.0
Goiás;Área 001;21552;21552;21552;0;0;5206206003001.0
Goiás;Área 002;25028;24996;24973;23;32;5206206003002.0
Goiás;Formosa;100085;100063;100041;22;22;5208004.0
Goiás;Área 001;13946;13946;13946;0;0;5208004003001.0
Goiás;Área 002;14206;14206;14206;0;0;5208004003002.0
Goiás;Área 003;26335;26335;26313;22;0;5208004003003.0
Goiás;Área 004;22346;22334;22334;0;12;5208004003004.0
Goiás;Área 005;23252;23241;23241;0;11;5208004003005.0
Goiás;Goianésia;59549;59480;59471;9;69;5208608.0
Goiás;Área 001;14963;14963;14963;0;0;5208608003001.0
Goiás;Área 002;18169;18157;18157;0;12;5208608003002.0
Goiás;Área 003;26417;26360;26351;9;57;5208608003003.0
Goiás;Goiânia;1302001;1299718;1298633;1086;2283;5208707.0
Goiás;Centro 01;39667;39667;39638;29;0;5208707005001.0
Goiás;Centro 02;44352;44221;44208;13;131;5208707005002.0
Goiás;Centro 03;24107;24066;24053;13;41;5208707005003.0
Goiás;Centro 04;23868;23746;23746;0;122;5208707005004.0
Goiás;Centro 05;25328;25239;25239;0;89;5208707005005.0
Goiás;Centro 06;33823;33631;33576;54;192;5208707005006.0
Goiás;Centro 07;30319;30280;30224;56;39;5208707005007.0
Goiás;Leste 01;27979;27910;27889;21;69;5208707005008.0
Goiás;Leste 02;30936;30890;30868;23;46;5208707005009.0
Goiás;Leste 03;28765;28671;28671;0;94;5208707005010.0
Goiás;Leste 04;30336;30336;30336;0;0;5208707005011.0
Goiás;Leste 05;26756;26727;26727;0;29;5208707005012.0
Goiás;Leste 06;28168;28039;28015;24;129;5208707005013.0
Goiás;Noroeste 01;29760;29728;29658;70;32;5208707005014.0
Goiás;Noroeste 02;30901;30819;30819;0;82;5208707005015.0
Goiás;Noroeste 03;29664;29644;29615;28;20;5208707005016.0
Goiás;Noroeste 04;37715;37686;37686;0;29;5208707005017.0
Goiás;Noroeste 05;36345;36345;36345;0;0;5208707005018.0
Goiás;Norte 01;30413;30392;30373;19;21;5208707005019.0
Goiás;Norte 02;30191;30146;30146;0;45;5208707005020.0
Goiás;Norte 03;30055;30032;30002;30;23;5208707005021.0
Goiás;Norte 04;28095;28095;28095;0;0;5208707005022.0
Goiás;Norte 05;27419;27419;27393;26;0;5208707005023.0
Goiás;Oeste 01;28413;28390;28390;0;23;5208707005024.0
Goiás;Oeste 02;28060;28060;28018;42;0;5208707005025.0
Goiás;Oeste 03;32889;32889;32837;52;0;5208707005026.0
Goiás;Oeste 04;30782;30728;30728;0;54;5208707005027.0
Goiás;Oeste 05;32978;32957;32957;0;21;5208707005028.0
Goiás;Sudoeste 01;26725;26591;26591;0;134;5208707005029.0
Goiás;Sudoeste 02;28109;28009;27994;15;100;5208707005030.0
Goiás;Sudoeste 03;28358;28284;28262;22;74;5208707005031.0
Goiás;Sudoeste 04;27749;27749;27721;28;0;5208707005032.0
Goiás;Sudoeste 05;32434;32394;32311;84;40;5208707005033.0
Goiás;Sudoeste 06;36959;36933;36933;0;26;5208707005034.0
Goiás;Sudoeste 07;41658;41658;41658;0;0;5208707005035.0
Goiás;Sul 01;24035;23991;23901;90;44;5208707005036.0
Goiás;Sul 02;26945;26830;26748;82;115;5208707005037.0
Goiás;Sul 03;26304;26284;26198;86;20;5208707005038.0
Goiás;Sul 04;22553;22513;22500;13;40;5208707005039.0
Goiás;Sul 05;25265;25201;25201;0;64;5208707005040.0
Goiás;Sul 06;29570;29376;29330;46;194;5208707005041.0
Goiás;Sul 07;36380;36279;36160;119;101;5208707005042.0
Goiás;Sul 08;30873;30873;30873;0;0;5208707005043.0
Goiás;Goianira;34060;34036;34036;0;24;5208806.0
Goiás;Área 001;14474;14450;14450;0;24;5208806003001.0
Goiás;Área 002;19586;19586;19586;0;0;5208806003002.0
Goiás;Goiás;24727;24719;24712;7;8;5208905.0
Goiás;Área 001;12211;12203;12196;7;8;5208905003001.0
Goiás;Área 002;12516;12516;12516;0;0;5208905003002.0
Goiás;Goiatuba;32492;32461;32461;0;31;5209101.0
Goiás;Área 001;13279;13269;13269;0;10;5209101003001.0
Goiás;Área 002;19213;19192;19192;0;21;5209101003002.0
Goiás;Inhumas;48246;48246;48212;34;0;5210000.0
Goiás;Área 001;20059;20059;20038;21;0;5210000003001.0
Goiás;Área 002;28187;28187;28173;14;0;5210000003002.0
Goiás;Iporá;31274;31261;31241;21;13;5210208.0
Goiás;Área 001;13653;13640;13620;21;13;5210208003001.0
Goiás;Área 002;17621;17621;17621;0;0;5210208003002.0
Goiás;Itaberaí;35371;35279;35279;0;92;5210406.0
Goiás;Área 001;13449;13449;13449;0;0;5210406003001.0
Goiás;Área 002;21922;21830;21830;0;92;5210406003002.0
Goiás;Itapuranga;26125;26125;26125;0;0;5211206.0
Goiás;Área 001;11922;11922;11922;0;0;5211206003001.0
Goiás;Área 002;14203;14203;14203;0;0;5211206003002.0
Goiás;Itumbiara;92883;92804;92772;32;79;5211503.0
Goiás;Área 001;12652;12652;12652;0;0;5211503003001.0
Goiás;Área 002;13113;13041;13009;32;72;5211503003002.0
Goiás;Área 003;22185;22185;22185;0;0;5211503003003.0
Goiás;Área 004;22038;22038;22038;0;0;5211503003004.0
Goiás;Área 005;22895;22888;22888;0;7;5211503003005.0
Goiás;Jaraguá;41870;41807;41743;64;63;5211800.0
Goiás;Área 001;15903;15868;15815;53;35;5211800003001.0
Goiás;Área 002;25967;25939;25928;11;28;5211800003002.0
Goiás;Jataí;88006;87907;87865;42;99;5211909.0
Goiás;Área 001;15708;15702;15702;0;6;5211909003001.0
Goiás;Área 002;13799;13741;13741;0;58;5211909003002.0
Goiás;Área 003;23859;23824;23782;42;35;5211909003003.0
Goiás;Área 004;34640;34640;34640;0;0;5211909003004.0
Goiás;Luziânia;174531;174465;174414;51;66;5212501.0
Goiás;Área 001;16782;16782;16782;0;0;5212501003001.0
Goiás;Área 002;15457;15457;15449;8;0;5212501003002.0
Goiás;Área 003;40329;40317;40317;0;12;5212501003003.0
Goiás;Área 004;16027;16027;16027;0;0;5212501003004.0
Goiás;Área 005;25894;25877;25867;10;17;5212501003005.0
Goiás;Área 006;28171;28157;28125;33;14;5212501003006.0
Goiás;Área 007;31871;31847;31847;0;24;5212501003007.0
Goiás;Minaçu;31154;31145;31145;0;9;5213087.0
Goiás;Área 001;14609;14600;14600;0;9;5213087003001.0
Goiás;Área 002;16545;16545;16545;0;0;5213087003002.0
Goiás;Mineiros;52935;52911;52911;0;24;5213103.0
Goiás;Área 001;26621;26611;26611;0;10;5213103003001.0
Goiás;Área 002;26314;26300;26300;0;14;5213103003002.0
Goiás;Morrinhos;41460;41460;41460;0;0;5213806.0
Goiás;Área 001;18712;18712;18712;0;0;5213806003001.0
Goiás;Área 002;22748;22748;22748;0;0;5213806003002.0
Goiás;Niquelândia;42361;42361;42361;0;0;5214606.0
Goiás;Área 001;18909;18909;18909;0;0;5214606003001.0
Goiás;Área 002;23452;23452;23452;0;0;5214606003002.0
Goiás;Novo Gama;95018;94992;94959;33;26;5215231.0
Goiás;Área 001;16608;16582;16569;13;26;5215231003001.0
Goiás;Área 002;31393;31393;31393;0;0;5215231003002.0
Goiás;Área 003;18576;18576;18576;0;0;5215231003003.0
Goiás;Área 004;28441;28441;28421;20;0;5215231003004.0
Goiás;Pires do Rio;28762;28749;28740;9;13;5217401.0
Goiás;Área 001;12566;12553;12553;0;13;5217401003001.0
Goiás;Área 002;16196;16196;16187;9;0;5217401003002.0
Goiás;Planaltina;81649;81649;81649;0;0;5217609.0
Goiás;Área 001;19642;19642;19642;0;0;5217609003001.0
Goiás;Área 002;29456;29456;29456;0;0;5217609003002.0
Goiás;Área 003;32551;32551;32551;0;0;5217609003003.0
Goiás;Porangatu;42355;42331;42318;14;24;5218003.0
Goiás;Área 001;19770;19770;19770;0;0;5218003003001.0
Goiás;Área 002;22585;22561;22548;14;24;5218003003002.0
Goiás;Posse;31419;31395;31395;0;24;5218300.0
Goiás;Área 001;14756;14732;14732;0;24;5218300003001.0
Goiás;Área 002;16663;16663;16663;0;0;5218300003002.0
Goiás;Quirinópolis;43220;43209;43191;18;11;5218508.0
Goiás;Área 001;19797;19797;19779;18;0;5218508003001.0
Goiás;Área 002;23423;23412;23412;0;11;5218508003002.0
Goiás;Rio Verde;176424;176298;176259;40;126;5218805.0
Goiás;Área 001;16106;16063;16063;0;43;5218805003001.0
Goiás;Área 002;15806;15799;15799;0;7;5218805003002.0
Goiás;Área 003;17386;17344;17344;0;42;5218805003003.0
Goiás;Área 004;15248;15248;15248;0;0;5218805003004.0
Goiás;Área 005;19348;19348;19340;8;0;5218805003005.0
Goiás;Área 006;33378;33355;33336;19;23;5218805003006.0
Goiás;Área 007;25536;25536;25523;13;0;5218805003007.0
Goiás;Área 008;33616;33606;33606;0;10;5218805003008.0
Goiás;Santa Helena de Goiás;36469;36469;36450;19;0;5219308.0
Goiás;Área 001;12340;12340;12321;19;0;5219308003001.0
Goiás;Área 002;24129;24129;24129;0;0;5219308003002.0
Goiás;Santo Antônio do Descoberto;63248;63220;63187;33;28;5219753.0
Goiás;Área 001;30045;30017;30008;9;28;5219753003001.0
Goiás;Área 002;33203;33203;33179;24;0;5219753003002.0
Goiás;São Luís de Montes Belos;30034;30024;30024;0;10;5220108.0
Goiás;Área 001;12950;12950;12950;0;0;5220108003001.0
Goiás;Área 002;17084;17074;17074;0;10;5220108003002.0
Goiás;Senador Canedo;84443;84377;84310;67;66;5220454.0
Goiás;Área 001;15588;15579;15570;9;9;5220454003001.0
Goiás;Área 002;26441;26417;26380;36;24;5220454003002.0
Goiás;Área 003;42414;42382;42360;22;32;5220454003003.0
Goiás;Trindade;104488;104468;104449;19;20;5221403.0
Goiás;Área 001;14920;14920;14909;11;0;5221403003001.0
Goiás;Área 002;15286;15286;15286;0;0;5221403003002.0
Goiás;Área 003;14840;14820;14820;0;20;5221403003003.0
Goiás;Área 004;17060;17060;17060;0;0;5221403003004.0
Goiás;Área 005;42382;42382;42373;9;0;5221403003005.0
Goiás;Uruaçu;36929;36929;36920;9;0;5221601.0
Goiás;Área 001;12295;12295;12295;0;0;5221601003001.0
Goiás;Área 002;24634;24634;24625;9;0;5221601003002.0
Goiás;Valparaíso de Goiás;132982;132857;132823;34;125;5221858.0
Goiás;Área 001;15343;15329;15320;9;14;5221858003001.0
Goiás;Área 002;14601;14573;14573;0;28;5221858003002.0
Goiás;Área 003;14102;14102;14077;25;0;5221858003003.0
Goiás;Área 004;15422;15410;15410;0;12;5221858003004.0
Goiás;Área 005;19804;19786;19786;0;18;5221858003005.0
Goiás;Área 006;25439;25398;25398;0;41;5221858003006.0
Goiás;Área 007;28271;28259;28259;0;12;5221858003007.0
Distrito Federal;Brasília;2570160;2564370;2561583;2787;5790;5300108.0
Distrito Federal;Águas Claras-Complemento;34872;34804;34781;22;68;5300108005012.0
Distrito Federal;Águas Claras-Vertical;59422;59195;59085;109;227;5300108005011.0
Distrito Federal;Arapoanga;36406;36340;36340;0;66;5300108005017.0
Distrito Federal;Asa Norte;104006;103128;102510;618;878;5300108005001.0
Distrito Federal;Asa Sul;78883;77746;77501;244;1137;5300108005002.0
Distrito Federal;Brazlândia;42353;42353;42353;0;0;5300108005013.0
Distrito Federal;Candangolândia;15924;15912;15912;0;12;5300108005049.0
Distrito Federal;Cond. Planaltina(Mestre de Armas-Aprodarmas e Vale);49702;49672;49672;0;30;5300108005018.0
Distrito Federal;Cruzeiro;29939;29877;29866;11;62;5300108005034.0
Distrito Federal;Guara I;44480;44370;44370;0;110;5300108005032.0
Distrito Federal;Guara II;61055;61055;61009;46;0;5300108005033.0
Distrito Federal;Guara-Complemento (Estrutura-Sia-Etcl);35536;35536;35536;0;0;5300108005031.0
Distrito Federal;Itapoã;50191;50191;50191;0;0;5300108005014.0
Distrito Federal;Lago Norte;41627;41406;41227;179;221;5300108005048.0
Distrito Federal;Lago Sul;45025;43698;43113;585;1327;5300108005045.0
Distrito Federal;Núcleo Bandeirante;27018;26957;26957;0;61;5300108005021.0
Distrito Federal;Paranoá;46328;46263;46223;39;65;5300108005020.0
Distrito Federal;Planaltina;71657;71657;71631;26;0;5300108005019.0
Distrito Federal;Plano Piloto-Complemento;26966;26788;26744;44;178;5300108005003.0
Distrito Federal;Quadras 100, 300 e 500-Impares;43946;43946;43946;0;0;5300108005036.0
Distrito Federal;Quadras 100, 300 e 500-Pares;49106;49106;49106;0;0;5300108005037.0
Distrito Federal;Quadras 200, 400 e 600-Impares;64317;64317;64293;24;0;5300108005038.0
Distrito Federal;Quadras 200, 400 e 600-Pares;40675;40675;40675;0;0;5300108005039.0
Distrito Federal;Recanto das Emas-Leste;66472;66472;66472;0;0;5300108005043.0
Distrito Federal;Recanto das Emas-Oeste;46614;46614;46614;0;0;5300108005044.0
Distrito Federal;Riacho Fundo I;33243;33208;33161;47;35;5300108005046.0
Distrito Federal;Riacho Fundo II;36807;36789;36789;0;18;5300108005047.0
Distrito Federal;Rural DF I;45654;45614;45547;66;40;5300108005051.0
Distrito Federal;Rural DF II;54363;54278;54209;70;85;5300108005050.0
Distrito Federal;Santa Maria-Leste;54961;54961;54961;0;0;5300108005040.0
Distrito Federal;Santa Maria-Oeste;61080;61058;61058;0;22;5300108005041.0
Distrito Federal;São Sebastião;88922;88772;88649;122;150;5300108005042.0
Distrito Federal;Setor Central, Industrial e Sul;45693;45678;45616;62;15;5300108005004.0
Distrito Federal;Setor de Industria e Expansão do Setor Oeste;51395;51395;51369;26;0;5300108005029.0
Distrito Federal;Setor Leste;37149;37131;37131;0;18;5300108005005.0
Distrito Federal;Setor M-Impar;36056;36056;36056;0;0;5300108005022.0
Distrito Federal;Setor M-Par;33119;33119;33119;0;0;5300108005023.0
Distrito Federal;Setor N-Impar;43765;43740;43740;0;25;5300108005024.0
Distrito Federal;Setor N-Par;41057;41057;41057;0;0;5300108005025.0
Distrito Federal;Setor Norte, Oeste e Expansão e Ponte de Terra;41365;41340;41340;0;25;5300108005006.0
Distrito Federal;Setor O;41388;41388;41388;0;0;5300108005026.0
Distrito Federal;Setor P Norte;29414;29414;29414;0;0;5300108005027.0
Distrito Federal;Setor P Sul;55113;55113;55113;0;0;5300108005028.0
Distrito Federal;Setores J, L e M Norte;80949;80892;80892;0;57;5300108005007.0
Distrito Federal;Sobradinho I;57912;57776;57730;46;136;5300108005015.0
Distrito Federal;Sobradinho II;82959;82820;82739;81;139;5300108005016.0
Distrito Federal;Sol Nascente;64585;64585;64559;26;0;5300108005030.0
Distrito Federal;Sudoeste-Octogonal;51136;50882;50755;126;254;5300108005035.0
Distrito Federal;Taguatinga Norte;66819;66709;66652;58;110;5300108005008.0
Distrito Federal;Taguatinga Sul;63232;63124;63080;44;108;5300108005009.0
Distrito Federal;Vicente Pires;59504;59395;59331;65;109;5300108005010.0
